"filename", "language", "TypeScript", "HTML", "Draw.io", "SCSS", "comment", "blank", "total"
"c:\Users\Josh\repos\doughleap\frontend\src\app\account\feature\login\login-page.component.html", "HTML", 0, 97, 0, 0, 54, 9, 160
"c:\Users\Josh\repos\doughleap\frontend\src\app\account\feature\login\login-page.component.spec.ts", "TypeScript", 17, 0, 0, 0, 0, 5, 22
"c:\Users\Josh\repos\doughleap\frontend\src\app\account\feature\login\login-page.component.ts", "TypeScript", 38, 0, 0, 0, 0, 6, 44
"c:\Users\Josh\repos\doughleap\frontend\src\app\account\feature\password\password-reset-page.component.html", "HTML", 0, 1, 0, 0, 0, 1, 2
"c:\Users\Josh\repos\doughleap\frontend\src\app\account\feature\password\password-reset-page.component.ts", "TypeScript", 10, 0, 0, 0, 0, 3, 13
"c:\Users\Josh\repos\doughleap\frontend\src\app\account\feature\signup\signup-page.component.html", "HTML", 0, 97, 0, 0, 54, 9, 160
"c:\Users\Josh\repos\doughleap\frontend\src\app\account\feature\signup\signup-page.component.ts", "TypeScript", 38, 0, 0, 0, 0, 6, 44
"c:\Users\Josh\repos\doughleap\frontend\src\app\account\feature\verify\verify.component.html", "HTML", 0, 1, 0, 0, 0, 1, 2
"c:\Users\Josh\repos\doughleap\frontend\src\app\account\feature\verify\verify.component.ts", "TypeScript", 10, 0, 0, 0, 0, 3, 13
"c:\Users\Josh\repos\doughleap\frontend\src\app\app.component.html", "HTML", 0, 3, 0, 0, 0, 1, 4
"c:\Users\Josh\repos\doughleap\frontend\src\app\app.component.spec.ts", "TypeScript", 25, 0, 0, 0, 0, 5, 30
"c:\Users\Josh\repos\doughleap\frontend\src\app\app.component.ts", "TypeScript", 44, 0, 0, 0, 2, 6, 52
"c:\Users\Josh\repos\doughleap\frontend\src\app\employees\data\employee.service.ts", "TypeScript", 24, 0, 0, 0, 0, 9, 33
"c:\Users\Josh\repos\doughleap\frontend\src\app\employees\feature\employees\employees.component.html", "HTML", 0, 1, 0, 0, 0, 1, 2
"c:\Users\Josh\repos\doughleap\frontend\src\app\employees\feature\employees\employees.component.ts", "TypeScript", 10, 0, 0, 0, 0, 3, 13
"c:\Users\Josh\repos\doughleap\frontend\src\app\employees\state\employee-actions.ts", "TypeScript", 31, 0, 0, 0, 0, 3, 34
"c:\Users\Josh\repos\doughleap\frontend\src\app\employees\state\employee-effects.ts", "TypeScript", 47, 0, 0, 0, 0, 4, 51
"c:\Users\Josh\repos\doughleap\frontend\src\app\employees\state\employee-reducers.ts", "TypeScript", 31, 0, 0, 0, 0, 2, 33
"c:\Users\Josh\repos\doughleap\frontend\src\app\employees\state\employee-selectors.ts", "TypeScript", 8, 0, 0, 0, 0, 3, 11
"c:\Users\Josh\repos\doughleap\frontend\src\app\employees\state\employee-state.ts", "TypeScript", 22, 0, 0, 0, 2, 2, 26
"c:\Users\Josh\repos\doughleap\frontend\src\app\guards\profile.guard.ts", "TypeScript", 30, 0, 0, 0, 3, 3, 36
"c:\Users\Josh\repos\doughleap\frontend\src\app\header\feature\app-header.component.html", "HTML", 0, 279, 0, 0, 3, 3, 285
"c:\Users\Josh\repos\doughleap\frontend\src\app\header\feature\app-header.component.ts", "TypeScript", 79, 0, 0, 0, 0, 10, 89
"c:\Users\Josh\repos\doughleap\frontend\src\app\home\feature\home\home.component.html", "HTML", 0, 1, 0, 0, 0, 1, 2
"c:\Users\Josh\repos\doughleap\frontend\src\app\home\feature\home\home.component.spec.ts", "TypeScript", 17, 0, 0, 0, 0, 5, 22
"c:\Users\Josh\repos\doughleap\frontend\src\app\home\feature\home\home.component.ts", "TypeScript", 10, 0, 0, 0, 0, 3, 13
"c:\Users\Josh\repos\doughleap\frontend\src\app\kitchen\feature\Inventory\feature\ingredient-inventory\data\ingredient-stock.service.ts", "TypeScript", 78, 0, 0, 0, 1, 10, 89
"c:\Users\Josh\repos\doughleap\frontend\src\app\kitchen\feature\Inventory\feature\ingredient-inventory\ingredient-inventory-table.component.html", "HTML", 0, 4, 0, 0, 0, 1, 5
"c:\Users\Josh\repos\doughleap\frontend\src\app\kitchen\feature\Inventory\feature\ingredient-inventory\ingredient-inventory-table.component.ts", "TypeScript", 91, 0, 0, 0, 0, 6, 97
"c:\Users\Josh\repos\doughleap\frontend\src\app\kitchen\feature\Inventory\feature\ingredient-inventory\state\ingredient-stock-actions.ts", "TypeScript", 76, 0, 0, 0, 0, 5, 81
"c:\Users\Josh\repos\doughleap\frontend\src\app\kitchen\feature\Inventory\feature\ingredient-inventory\state\ingredient-stock-effects.ts", "TypeScript", 118, 0, 0, 0, 0, 7, 125
"c:\Users\Josh\repos\doughleap\frontend\src\app\kitchen\feature\Inventory\feature\ingredient-inventory\state\ingredient-stock-reducers.ts", "TypeScript", 115, 0, 0, 0, 0, 2, 117
"c:\Users\Josh\repos\doughleap\frontend\src\app\kitchen\feature\Inventory\feature\ingredient-inventory\state\ingredient-stock-selectors.ts", "TypeScript", 23, 0, 0, 0, 0, 9, 32
"c:\Users\Josh\repos\doughleap\frontend\src\app\kitchen\feature\Inventory\feature\ingredient-inventory\state\ingredient-stock-state.ts", "TypeScript", 29, 0, 0, 0, 0, 4, 33
"c:\Users\Josh\repos\doughleap\frontend\src\app\kitchen\feature\Inventory\feature\ingredient-inventory\ui\add-ingredient-stock-modal\add-ingredient-stock-modal.component.html", "HTML", 0, 142, 0, 0, 2, 6, 150
"c:\Users\Josh\repos\doughleap\frontend\src\app\kitchen\feature\Inventory\feature\ingredient-inventory\ui\add-ingredient-stock-modal\add-ingredient-stock-modal.component.ts", "TypeScript", 187, 0, 0, 0, 3, 21, 211
"c:\Users\Josh\repos\doughleap\frontend\src\app\kitchen\feature\Inventory\feature\ingredient-inventory\ui\delete-ingredient-stock-modal\delete-ingredient-stock-modal.component.html", "HTML", 0, 56, 0, 0, 0, 1, 57
"c:\Users\Josh\repos\doughleap\frontend\src\app\kitchen\feature\Inventory\feature\ingredient-inventory\ui\delete-ingredient-stock-modal\delete-ingredient-stock-modal.component.ts", "TypeScript", 54, 0, 0, 0, 1, 8, 63
"c:\Users\Josh\repos\doughleap\frontend\src\app\kitchen\feature\Inventory\feature\ingredient-inventory\ui\edit-ingredient-stock-modal\edit-ingredient-stock-modal.component.html", "HTML", 0, 127, 0, 0, 2, 5, 134
"c:\Users\Josh\repos\doughleap\frontend\src\app\kitchen\feature\Inventory\feature\ingredient-inventory\ui\edit-ingredient-stock-modal\edit-ingredient-stock-modal.component.ts", "TypeScript", 206, 0, 0, 0, 0, 22, 228
"c:\Users\Josh\repos\doughleap\frontend\src\app\kitchen\feature\Inventory\feature\material-inventory\material-inventory-table.component.html", "HTML", 0, 1, 0, 0, 0, 1, 2
"c:\Users\Josh\repos\doughleap\frontend\src\app\kitchen\feature\Inventory\feature\material-inventory\material-inventory-table.component.spec.ts", "TypeScript", 17, 0, 0, 0, 0, 5, 22
"c:\Users\Josh\repos\doughleap\frontend\src\app\kitchen\feature\Inventory\feature\material-inventory\material-inventory-table.component.ts", "TypeScript", 10, 0, 0, 0, 0, 3, 13
"c:\Users\Josh\repos\doughleap\frontend\src\app\kitchen\feature\Inventory\inventory.component.html", "HTML", 0, 10, 0, 0, 0, 1, 11
"c:\Users\Josh\repos\doughleap\frontend\src\app\kitchen\feature\Inventory\inventory.component.ts", "TypeScript", 21, 0, 0, 0, 0, 4, 25
"c:\Users\Josh\repos\doughleap\frontend\src\app\kitchen\feature\ingredients\data\ingredient.service.ts", "TypeScript", 46, 0, 0, 0, 0, 9, 55
"c:\Users\Josh\repos\doughleap\frontend\src\app\kitchen\feature\ingredients\ingredients.component.html", "HTML", 0, 24, 0, 0, 0, 0, 24
"c:\Users\Josh\repos\doughleap\frontend\src\app\kitchen\feature\ingredients\ingredients.component.ts", "TypeScript", 96, 0, 0, 0, 0, 5, 101
"c:\Users\Josh\repos\doughleap\frontend\src\app\kitchen\feature\ingredients\state\ingredient-actions.ts", "TypeScript", 76, 0, 0, 0, 0, 5, 81
"c:\Users\Josh\repos\doughleap\frontend\src\app\kitchen\feature\ingredients\state\ingredient-effects.ts", "TypeScript", 120, 0, 0, 0, 0, 10, 130
"c:\Users\Josh\repos\doughleap\frontend\src\app\kitchen\feature\ingredients\state\ingredient-reducers.ts", "TypeScript", 101, 0, 0, 0, 0, 3, 104
"c:\Users\Josh\repos\doughleap\frontend\src\app\kitchen\feature\ingredients\state\ingredient-selectors.ts", "TypeScript", 13, 0, 0, 0, 0, 7, 20
"c:\Users\Josh\repos\doughleap\frontend\src\app\kitchen\feature\ingredients\state\ingredient-state.ts", "TypeScript", 22, 0, 0, 0, 0, 3, 25
"c:\Users\Josh\repos\doughleap\frontend\src\app\kitchen\feature\ingredients\ui\add-ingredient-modal\add-ingredient-modal.component.html", "HTML", 0, 124, 0, 0, 2, 7, 133
"c:\Users\Josh\repos\doughleap\frontend\src\app\kitchen\feature\ingredients\ui\add-ingredient-modal\add-ingredient-modal.component.ts", "TypeScript", 110, 0, 0, 0, 0, 11, 121
"c:\Users\Josh\repos\doughleap\frontend\src\app\kitchen\feature\ingredients\ui\delete-ingredient-modal\delete-ingredient-modal.component.html", "HTML", 0, 48, 0, 0, 0, 1, 49
"c:\Users\Josh\repos\doughleap\frontend\src\app\kitchen\feature\ingredients\ui\delete-ingredient-modal\delete-ingredient-modal.component.ts", "TypeScript", 53, 0, 0, 0, 1, 8, 62
"c:\Users\Josh\repos\doughleap\frontend\src\app\kitchen\feature\ingredients\ui\edit-ingredient-modal\edit-ingredient-modal.component.html", "HTML", 0, 123, 0, 0, 2, 6, 131
"c:\Users\Josh\repos\doughleap\frontend\src\app\kitchen\feature\ingredients\ui\edit-ingredient-modal\edit-ingredient-modal.component.ts", "TypeScript", 161, 0, 0, 0, 0, 14, 175
"c:\Users\Josh\repos\doughleap\frontend\src\app\kitchen\feature\tools\data\tool.service.ts", "TypeScript", 43, 0, 0, 0, 0, 9, 52
"c:\Users\Josh\repos\doughleap\frontend\src\app\kitchen\feature\tools\state\tool-actions.ts", "TypeScript", 76, 0, 0, 0, 0, 7, 83
"c:\Users\Josh\repos\doughleap\frontend\src\app\kitchen\feature\tools\state\tool-effects.ts", "TypeScript", 126, 0, 0, 0, 0, 6, 132
"c:\Users\Josh\repos\doughleap\frontend\src\app\kitchen\feature\tools\state\tool-reducers.ts", "TypeScript", 98, 0, 0, 0, 0, 2, 100
"c:\Users\Josh\repos\doughleap\frontend\src\app\kitchen\feature\tools\state\tool-selectors.ts", "TypeScript", 13, 0, 0, 0, 0, 8, 21
"c:\Users\Josh\repos\doughleap\frontend\src\app\kitchen\feature\tools\state\tool-state.ts", "TypeScript", 19, 0, 0, 0, 0, 2, 21
"c:\Users\Josh\repos\doughleap\frontend\src\app\kitchen\feature\tools\tools.component.html", "HTML", 0, 24, 0, 0, 0, 1, 25
"c:\Users\Josh\repos\doughleap\frontend\src\app\kitchen\feature\tools\tools.component.ts", "TypeScript", 64, 0, 0, 0, 0, 5, 69
"c:\Users\Josh\repos\doughleap\frontend\src\app\kitchen\feature\tools\ui\add-tool-modal\add-tool-modal.component.html", "HTML", 0, 92, 0, 0, 2, 4, 98
"c:\Users\Josh\repos\doughleap\frontend\src\app\kitchen\feature\tools\ui\add-tool-modal\add-tool-modal.component.ts", "TypeScript", 94, 0, 0, 0, 0, 10, 104
"c:\Users\Josh\repos\doughleap\frontend\src\app\kitchen\feature\tools\ui\delete-tool-modal\delete-tool-modal.component.html", "HTML", 0, 48, 0, 0, 0, 1, 49
"c:\Users\Josh\repos\doughleap\frontend\src\app\kitchen\feature\tools\ui\delete-tool-modal\delete-tool-modal.component.ts", "TypeScript", 53, 0, 0, 0, 1, 7, 61
"c:\Users\Josh\repos\doughleap\frontend\src\app\kitchen\feature\tools\ui\edit-tool-modal\edit-tool-modal.component.html", "HTML", 0, 84, 0, 0, 2, 3, 89
"c:\Users\Josh\repos\doughleap\frontend\src\app\kitchen\feature\tools\ui\edit-tool-modal\edit-tool-modal.component.ts", "TypeScript", 108, 0, 0, 0, 0, 15, 123
"c:\Users\Josh\repos\doughleap\frontend\src\app\kitchen\kitchen-page.component.html", "HTML", 0, 104, 0, 0, 2, 2, 108
"c:\Users\Josh\repos\doughleap\frontend\src\app\kitchen\kitchen-page.component.ts", "TypeScript", 27, 0, 0, 0, 0, 6, 33
"c:\Users\Josh\repos\doughleap\frontend\src\app\kitchen\state\kitchen-actions.ts", "TypeScript", 16, 0, 0, 0, 0, 3, 19
"c:\Users\Josh\repos\doughleap\frontend\src\app\kitchen\state\kitchen-interfaces.ts", "TypeScript", 16, 0, 0, 0, 0, 2, 18
"c:\Users\Josh\repos\doughleap\frontend\src\app\kitchen\state\kitchen-reducers.ts", "TypeScript", 18, 0, 0, 0, 1, 4, 23
"c:\Users\Josh\repos\doughleap\frontend\src\app\kitchen\state\kitchen-selectors.ts", "TypeScript", 6, 0, 0, 0, 0, 2, 8
"c:\Users\Josh\repos\doughleap\frontend\src\app\kitchen\state\kitchen-state.ts", "TypeScript", 4, 0, 0, 0, 0, 0, 4
"c:\Users\Josh\repos\doughleap\frontend\src\app\recipes\data\recipe-category.service.ts", "TypeScript", 47, 0, 0, 0, 0, 9, 56
"c:\Users\Josh\repos\doughleap\frontend\src\app\recipes\data\recipe-ingredients.service.ts", "TypeScript", 53, 0, 0, 0, 0, 9, 62
"c:\Users\Josh\repos\doughleap\frontend\src\app\recipes\data\recipe-step.service.ts", "TypeScript", 45, 0, 0, 0, 0, 9, 54
"c:\Users\Josh\repos\doughleap\frontend\src\app\recipes\data\recipe-tool.service.ts", "TypeScript", 49, 0, 0, 0, 0, 9, 58
"c:\Users\Josh\repos\doughleap\frontend\src\app\recipes\data\recipe.service.ts", "TypeScript", 150, 0, 0, 0, 0, 12, 162
"c:\Users\Josh\repos\doughleap\frontend\src\app\recipes\data\step.service.ts", "TypeScript", 41, 0, 0, 0, 0, 8, 49
"c:\Users\Josh\repos\doughleap\frontend\src\app\recipes\feature\recipe\recipe.component.html", "HTML", 0, 204, 0, 0, 8, 4, 216
"c:\Users\Josh\repos\doughleap\frontend\src\app\recipes\feature\recipe\recipe.component.ts", "TypeScript", 408, 0, 0, 0, 1, 27, 436
"c:\Users\Josh\repos\doughleap\frontend\src\app\recipes\feature\recipe\ui\delete-recipe-modal\delete-recipe-modal.component.html", "HTML", 0, 48, 0, 0, 0, 1, 49
"c:\Users\Josh\repos\doughleap\frontend\src\app\recipes\feature\recipe\ui\delete-recipe-modal\delete-recipe-modal.component.ts", "TypeScript", 56, 0, 0, 0, 1, 8, 65
"c:\Users\Josh\repos\doughleap\frontend\src\app\recipes\feature\recipe\ui\edit-recipe-modal\edit-recipe-modal.component.html", "HTML", 0, 202, 0, 0, 2, 4, 208
"c:\Users\Josh\repos\doughleap\frontend\src\app\recipes\feature\recipe\ui\edit-recipe-modal\edit-recipe-modal.component.ts", "TypeScript", 245, 0, 0, 0, 7, 20, 272
"c:\Users\Josh\repos\doughleap\frontend\src\app\recipes\feature\recipes-page\recipes-page.component.html", "HTML", 0, 429, 0, 0, 13, 11, 453
"c:\Users\Josh\repos\doughleap\frontend\src\app\recipes\feature\recipes-page\recipes-page.component.scss", "SCSS", 0, 0, 0, 8, 0, 1, 9
"c:\Users\Josh\repos\doughleap\frontend\src\app\recipes\feature\recipes-page\recipes-page.component.ts", "TypeScript", 687, 0, 0, 0, 20, 52, 759
"c:\Users\Josh\repos\doughleap\frontend\src\app\recipes\feature\recipes-page\test.drawio", "Draw.io", 0, 0, 59, 0, 0, 0, 59
"c:\Users\Josh\repos\doughleap\frontend\src\app\recipes\feature\recipes-page\ui\recipe-category\add-recipe-category-modal\add-recipe-category-modal.component.html", "HTML", 0, 112, 0, 0, 2, 4, 118
"c:\Users\Josh\repos\doughleap\frontend\src\app\recipes\feature\recipes-page\ui\recipe-category\add-recipe-category-modal\add-recipe-category-modal.component.ts", "TypeScript", 148, 0, 0, 0, 2, 20, 170
"c:\Users\Josh\repos\doughleap\frontend\src\app\recipes\feature\recipes-page\ui\recipe-category\delete-recipe-category-modal\delete-recipe-category-modal.component.html", "HTML", 0, 52, 0, 0, 0, 1, 53
"c:\Users\Josh\repos\doughleap\frontend\src\app\recipes\feature\recipes-page\ui\recipe-category\delete-recipe-category-modal\delete-recipe-category-modal.component.ts", "TypeScript", 58, 0, 0, 0, 1, 7, 66
"c:\Users\Josh\repos\doughleap\frontend\src\app\recipes\feature\recipes-page\ui\recipe-category\edit-recipe-category-modal\edit-recipe-category-modal.component.html", "HTML", 0, 93, 0, 0, 2, 4, 99
"c:\Users\Josh\repos\doughleap\frontend\src\app\recipes\feature\recipes-page\ui\recipe-category\edit-recipe-category-modal\edit-recipe-category-modal.component.ts", "TypeScript", 202, 0, 0, 0, 8, 24, 234
"c:\Users\Josh\repos\doughleap\frontend\src\app\recipes\feature\recipes-page\ui\recipe-ingredient\add-recipe-ingredient-modal\add-recipe-ingredient-modal.component.html", "HTML", 0, 157, 0, 0, 2, 3, 162
"c:\Users\Josh\repos\doughleap\frontend\src\app\recipes\feature\recipes-page\ui\recipe-ingredient\add-recipe-ingredient-modal\add-recipe-ingredient-modal.component.ts", "TypeScript", 140, 0, 0, 0, 4, 14, 158
"c:\Users\Josh\repos\doughleap\frontend\src\app\recipes\feature\recipes-page\ui\recipe-ingredient\delete-recipe-ingredient-modal\delete-recipe-ingredient-modal.component.html", "HTML", 0, 48, 0, 0, 0, 1, 49
"c:\Users\Josh\repos\doughleap\frontend\src\app\recipes\feature\recipes-page\ui\recipe-ingredient\delete-recipe-ingredient-modal\delete-recipe-ingredient-modal.component.ts", "TypeScript", 60, 0, 0, 0, 1, 7, 68
"c:\Users\Josh\repos\doughleap\frontend\src\app\recipes\feature\recipes-page\ui\recipe-ingredient\recipe-ingredients-modal\recipe-ingredients-modal.component.html", "HTML", 0, 106, 0, 0, 2, 3, 111
"c:\Users\Josh\repos\doughleap\frontend\src\app\recipes\feature\recipes-page\ui\recipe-ingredient\recipe-ingredients-modal\recipe-ingredients-modal.component.ts", "TypeScript", 211, 0, 0, 0, 6, 19, 236
"c:\Users\Josh\repos\doughleap\frontend\src\app\recipes\feature\recipes-page\ui\recipe-step\add-recipe-step-modal\add-recipe-step-modal.component.html", "HTML", 0, 133, 0, 0, 2, 4, 139
"c:\Users\Josh\repos\doughleap\frontend\src\app\recipes\feature\recipes-page\ui\recipe-step\add-recipe-step-modal\add-recipe-step-modal.component.ts", "TypeScript", 162, 0, 0, 0, 2, 20, 184
"c:\Users\Josh\repos\doughleap\frontend\src\app\recipes\feature\recipes-page\ui\recipe-step\delete-recipe-step-modal\delete-recipe-step-modal.component.html", "HTML", 0, 48, 0, 0, 0, 1, 49
"c:\Users\Josh\repos\doughleap\frontend\src\app\recipes\feature\recipes-page\ui\recipe-step\delete-recipe-step-modal\delete-recipe-step-modal.component.ts", "TypeScript", 63, 0, 0, 0, 1, 8, 72
"c:\Users\Josh\repos\doughleap\frontend\src\app\recipes\feature\recipes-page\ui\recipe-step\edit-recipe-step-modal\edit-recipe-step-modal.component.html", "HTML", 0, 107, 0, 0, 2, 4, 113
"c:\Users\Josh\repos\doughleap\frontend\src\app\recipes\feature\recipes-page\ui\recipe-step\edit-recipe-step-modal\edit-recipe-step-modal.component.ts", "TypeScript", 196, 0, 0, 0, 9, 16, 221
"c:\Users\Josh\repos\doughleap\frontend\src\app\recipes\feature\recipes-page\ui\recipe-step\recipe-steps-modal\recipe-steps-modal.component.html", "HTML", 0, 148, 0, 0, 2, 5, 155
"c:\Users\Josh\repos\doughleap\frontend\src\app\recipes\feature\recipes-page\ui\recipe-step\recipe-steps-modal\recipe-steps-modal.component.ts", "TypeScript", 501, 0, 0, 0, 25, 53, 579
"c:\Users\Josh\repos\doughleap\frontend\src\app\recipes\feature\recipes-page\ui\recipe-tool\add-recipe-tool-modal\add-recipe-tool-modal.component.html", "HTML", 0, 111, 0, 0, 2, 3, 116
"c:\Users\Josh\repos\doughleap\frontend\src\app\recipes\feature\recipes-page\ui\recipe-tool\add-recipe-tool-modal\add-recipe-tool-modal.component.ts", "TypeScript", 108, 0, 0, 0, 0, 10, 118
"c:\Users\Josh\repos\doughleap\frontend\src\app\recipes\feature\recipes-page\ui\recipe-tool\delete-recipe-tool-modal\delete-recipe-tool-modal.component.html", "HTML", 0, 51, 0, 0, 0, 1, 52
"c:\Users\Josh\repos\doughleap\frontend\src\app\recipes\feature\recipes-page\ui\recipe-tool\delete-recipe-tool-modal\delete-recipe-tool-modal.component.ts", "TypeScript", 67, 0, 0, 0, 1, 7, 75
"c:\Users\Josh\repos\doughleap\frontend\src\app\recipes\feature\recipes-page\ui\recipe-tool\recipe-tools-modal\recipe-tools-modal.component.html", "HTML", 0, 100, 0, 0, 2, 3, 105
"c:\Users\Josh\repos\doughleap\frontend\src\app\recipes\feature\recipes-page\ui\recipe-tool\recipe-tools-modal\recipe-tools-modal.component.ts", "TypeScript", 226, 0, 0, 0, 2, 18, 246
"c:\Users\Josh\repos\doughleap\frontend\src\app\recipes\feature\recipes-page\ui\recipe\add-recipe-modal\add-recipe-modal.component.html", "HTML", 0, 219, 0, 0, 2, 4, 225
"c:\Users\Josh\repos\doughleap\frontend\src\app\recipes\feature\recipes-page\ui\recipe\add-recipe-modal\add-recipe-modal.component.ts", "TypeScript", 208, 0, 0, 0, 2, 22, 232
"c:\Users\Josh\repos\doughleap\frontend\src\app\recipes\feature\recipes-page\ui\recipes-info\recipes-info.component.html", "HTML", 0, 4, 0, 0, 0, 1, 5
"c:\Users\Josh\repos\doughleap\frontend\src\app\recipes\feature\recipes-page\ui\recipes-info\recipes-info.component.ts", "TypeScript", 10, 0, 0, 0, 0, 3, 13
"c:\Users\Josh\repos\doughleap\frontend\src\app\recipes\state\recipe-category\recipe-category-actions.ts", "TypeScript", 76, 0, 0, 0, 0, 7, 83
"c:\Users\Josh\repos\doughleap\frontend\src\app\recipes\state\recipe-category\recipe-category-effects.ts", "TypeScript", 141, 0, 0, 0, 0, 7, 148
"c:\Users\Josh\repos\doughleap\frontend\src\app\recipes\state\recipe-category\recipe-category-reducers.ts", "TypeScript", 116, 0, 0, 0, 0, 3, 119
"c:\Users\Josh\repos\doughleap\frontend\src\app\recipes\state\recipe-category\recipe-category-selectors.ts", "TypeScript", 17, 0, 0, 0, 0, 8, 25
"c:\Users\Josh\repos\doughleap\frontend\src\app\recipes\state\recipe-category\recipe-category-state.ts", "TypeScript", 19, 0, 0, 0, 0, 2, 21
"c:\Users\Josh\repos\doughleap\frontend\src\app\recipes\state\recipe-ingredient\recipe-ingredient-actions.ts", "TypeScript", 76, 0, 0, 0, 0, 7, 83
"c:\Users\Josh\repos\doughleap\frontend\src\app\recipes\state\recipe-ingredient\recipe-ingredient-effects.ts", "TypeScript", 196, 0, 0, 0, 0, 8, 204
"c:\Users\Josh\repos\doughleap\frontend\src\app\recipes\state\recipe-ingredient\recipe-ingredient-reducers.ts", "TypeScript", 134, 0, 0, 0, 0, 4, 138
"c:\Users\Josh\repos\doughleap\frontend\src\app\recipes\state\recipe-ingredient\recipe-ingredient-selectors.ts", "TypeScript", 18, 0, 0, 0, 0, 9, 27
"c:\Users\Josh\repos\doughleap\frontend\src\app\recipes\state\recipe-ingredient\recipe-ingredient-state.ts", "TypeScript", 22, 0, 0, 0, 0, 2, 24
"c:\Users\Josh\repos\doughleap\frontend\src\app\recipes\state\recipe-page-actions.ts", "TypeScript", 8, 0, 0, 0, 0, 1, 9
"c:\Users\Josh\repos\doughleap\frontend\src\app\recipes\state\recipe-page-reducers.ts", "TypeScript", 10, 0, 0, 0, 0, 2, 12
"c:\Users\Josh\repos\doughleap\frontend\src\app\recipes\state\recipe-page-selectors.ts", "TypeScript", 4, 0, 0, 0, 0, 2, 6
"c:\Users\Josh\repos\doughleap\frontend\src\app\recipes\state\recipe-page-state.ts", "TypeScript", 3, 0, 0, 0, 0, 0, 3
"c:\Users\Josh\repos\doughleap\frontend\src\app\recipes\state\recipe-step\recipe-step-actions.ts", "TypeScript", 36, 0, 0, 0, 0, 8, 44
"c:\Users\Josh\repos\doughleap\frontend\src\app\recipes\state\recipe-step\recipe-step-effects.ts", "TypeScript", 195, 0, 0, 0, 45, 9, 249
"c:\Users\Josh\repos\doughleap\frontend\src\app\recipes\state\recipe-step\recipe-step-reducers.ts", "TypeScript", 98, 0, 0, 0, 0, 2, 100
"c:\Users\Josh\repos\doughleap\frontend\src\app\recipes\state\recipe-step\recipe-step-selectors.ts", "TypeScript", 18, 0, 0, 0, 0, 8, 26
"c:\Users\Josh\repos\doughleap\frontend\src\app\recipes\state\recipe-step\recipe-step-state.ts", "TypeScript", 21, 0, 0, 0, 0, 3, 24
"c:\Users\Josh\repos\doughleap\frontend\src\app\recipes\state\recipe-tool\recipe-tool-actions.ts", "TypeScript", 76, 0, 0, 0, 0, 6, 82
"c:\Users\Josh\repos\doughleap\frontend\src\app\recipes\state\recipe-tool\recipe-tool-effects.ts", "TypeScript", 185, 0, 0, 0, 0, 7, 192
"c:\Users\Josh\repos\doughleap\frontend\src\app\recipes\state\recipe-tool\recipe-tool-reducers.ts", "TypeScript", 133, 0, 0, 0, 0, 5, 138
"c:\Users\Josh\repos\doughleap\frontend\src\app\recipes\state\recipe-tool\recipe-tool-selectors.ts", "TypeScript", 18, 0, 0, 0, 0, 9, 27
"c:\Users\Josh\repos\doughleap\frontend\src\app\recipes\state\recipe-tool\recipe-tool-state.ts", "TypeScript", 20, 0, 0, 0, 0, 3, 23
"c:\Users\Josh\repos\doughleap\frontend\src\app\recipes\state\recipe\recipe-actions.ts", "TypeScript", 78, 0, 0, 0, 0, 8, 86
"c:\Users\Josh\repos\doughleap\frontend\src\app\recipes\state\recipe\recipe-effects.ts", "TypeScript", 143, 0, 0, 0, 0, 7, 150
"c:\Users\Josh\repos\doughleap\frontend\src\app\recipes\state\recipe\recipe-reducers.ts", "TypeScript", 103, 0, 0, 0, 0, 4, 107
"c:\Users\Josh\repos\doughleap\frontend\src\app\recipes\state\recipe\recipe-selectors.ts", "TypeScript", 17, 0, 0, 0, 8, 9, 34
"c:\Users\Josh\repos\doughleap\frontend\src\app\recipes\state\recipe\recipe-state.ts", "TypeScript", 48, 0, 0, 0, 1, 10, 59
"c:\Users\Josh\repos\doughleap\frontend\src\app\recipes\state\step\step-actions.ts", "TypeScript", 34, 0, 0, 0, 0, 6, 40
"c:\Users\Josh\repos\doughleap\frontend\src\app\recipes\state\step\step-effects.ts", "TypeScript", 121, 0, 0, 0, 0, 6, 127
"c:\Users\Josh\repos\doughleap\frontend\src\app\recipes\state\step\step-reducers.ts", "TypeScript", 93, 0, 0, 0, 0, 2, 95
"c:\Users\Josh\repos\doughleap\frontend\src\app\recipes\state\step\step-selectors.ts", "TypeScript", 19, 0, 0, 0, 0, 9, 28
"c:\Users\Josh\repos\doughleap\frontend\src\app\recipes\state\step\step-state.ts", "TypeScript", 19, 0, 0, 0, 0, 2, 21
"c:\Users\Josh\repos\doughleap\frontend\src\app\routes.ts", "TypeScript", 57, 0, 0, 0, 0, 2, 59
"c:\Users\Josh\repos\doughleap\frontend\src\app\shared\state\app-state.ts", "TypeScript", 8, 0, 0, 0, 0, 2, 10
"c:\Users\Josh\repos\doughleap\frontend\src\app\shared\state\shared-actions.ts", "TypeScript", 2, 0, 0, 0, 0, 2, 4
"c:\Users\Josh\repos\doughleap\frontend\src\app\shared\state\shared-reducers.ts", "TypeScript", 10, 0, 0, 0, 0, 3, 13
"c:\Users\Josh\repos\doughleap\frontend\src\app\shared\state\shared-selectors.ts", "TypeScript", 5, 0, 0, 0, 0, 3, 8
"c:\Users\Josh\repos\doughleap\frontend\src\app\shared\state\shared-state.ts", "TypeScript", 67, 0, 0, 0, 0, 6, 73
"c:\Users\Josh\repos\doughleap\frontend\src\app\shared\ui\add-request-confirmation\add-request-confirmation-modal.component.html", "HTML", 0, 22, 0, 0, 0, 0, 22
"c:\Users\Josh\repos\doughleap\frontend\src\app\shared\ui\add-request-confirmation\add-request-confirmation-modal.component.ts", "TypeScript", 21, 0, 0, 0, 0, 4, 25
"c:\Users\Josh\repos\doughleap\frontend\src\app\shared\ui\add-request-error\add-request-error-modal.component.html", "HTML", 0, 22, 0, 0, 5, 0, 27
"c:\Users\Josh\repos\doughleap\frontend\src\app\shared\ui\add-request-error\add-request-error-modal.component.ts", "TypeScript", 21, 0, 0, 0, 0, 4, 25
"c:\Users\Josh\repos\doughleap\frontend\src\app\shared\ui\app-notfound\app-notfound.component.html", "HTML", 0, 1, 0, 0, 0, 1, 2
"c:\Users\Josh\repos\doughleap\frontend\src\app\shared\ui\app-notfound\app-notfound.component.ts", "TypeScript", 10, 0, 0, 0, 0, 3, 13
"c:\Users\Josh\repos\doughleap\frontend\src\app\shared\ui\delete-request-confirmation\delete-request-confirmation-modal.component.html", "HTML", 0, 22, 0, 0, 0, 0, 22
"c:\Users\Josh\repos\doughleap\frontend\src\app\shared\ui\delete-request-confirmation\delete-request-confirmation-modal.component.ts", "TypeScript", 19, 0, 0, 0, 0, 4, 23
"c:\Users\Josh\repos\doughleap\frontend\src\app\shared\ui\delete-request-error\delete-request-error-modal.component.html", "HTML", 0, 22, 0, 0, 0, 0, 22
"c:\Users\Josh\repos\doughleap\frontend\src\app\shared\ui\delete-request-error\delete-request-error-modal.component.ts", "TypeScript", 19, 0, 0, 0, 0, 3, 22
"c:\Users\Josh\repos\doughleap\frontend\src\app\shared\ui\dl-table-full-filters\dl-table-full-filters.component.html", "HTML", 0, 170, 0, 0, 2, 2, 174
"c:\Users\Josh\repos\doughleap\frontend\src\app\shared\ui\dl-table-full-filters\dl-table-full-filters.component.ts", "TypeScript", 178, 0, 0, 0, 2, 21, 201
"c:\Users\Josh\repos\doughleap\frontend\src\app\shared\ui\dl-table-full\dl-table-full.component.html", "HTML", 0, 179, 0, 0, 1, 1, 181
"c:\Users\Josh\repos\doughleap\frontend\src\app\shared\ui\dl-table-full\dl-table-full.component.ts", "TypeScript", 314, 0, 0, 0, 6, 25, 345
"c:\Users\Josh\repos\doughleap\frontend\src\app\shared\ui\filterModals\currency-filter-modal\currency-filter-modal.component.html", "HTML", 0, 1, 0, 0, 0, 1, 2
"c:\Users\Josh\repos\doughleap\frontend\src\app\shared\ui\filterModals\currency-filter-modal\currency-filter-modal.component.ts", "TypeScript", 10, 0, 0, 0, 0, 3, 13
"c:\Users\Josh\repos\doughleap\frontend\src\app\shared\ui\filterModals\date-filter-modal\date-filter-modal.component.html", "HTML", 0, 104, 0, 0, 2, 2, 108
"c:\Users\Josh\repos\doughleap\frontend\src\app\shared\ui\filterModals\date-filter-modal\date-filter-modal.component.ts", "TypeScript", 131, 0, 0, 0, 3, 11, 145
"c:\Users\Josh\repos\doughleap\frontend\src\app\shared\ui\filterModals\numeric-filter-modal\numeric-filter-modal.component.html", "HTML", 0, 83, 0, 0, 2, 2, 87
"c:\Users\Josh\repos\doughleap\frontend\src\app\shared\ui\filterModals\numeric-filter-modal\numeric-filter-modal.component.ts", "TypeScript", 112, 0, 0, 0, 0, 10, 122
"c:\Users\Josh\repos\doughleap\frontend\src\app\shared\ui\filterModals\string-filter-modal\string-filter-modal.component.html", "HTML", 0, 63, 0, 0, 2, 2, 67
"c:\Users\Josh\repos\doughleap\frontend\src\app\shared\ui\filterModals\string-filter-modal\string-filter-modal.component.ts", "TypeScript", 80, 0, 0, 0, 2, 8, 90
"c:\Users\Josh\repos\doughleap\frontend\src\app\shared\ui\update-request-confirmation\update-request-confirmation-modal.component.html", "HTML", 0, 22, 0, 0, 0, 0, 22
"c:\Users\Josh\repos\doughleap\frontend\src\app\shared\ui\update-request-confirmation\update-request-confirmation-modal.component.ts", "TypeScript", 20, 0, 0, 0, 0, 8, 28
"c:\Users\Josh\repos\doughleap\frontend\src\app\shared\ui\update-request-error\update-request-error-modal.component.html", "HTML", 0, 22, 0, 0, 5, 0, 27
"c:\Users\Josh\repos\doughleap\frontend\src\app\shared\ui\update-request-error\update-request-error-modal.component.ts", "TypeScript", 20, 0, 0, 0, 0, 5, 25
"c:\Users\Josh\repos\doughleap\frontend\src\app\shared\utils\authInterceptor.ts", "TypeScript", 33, 0, 0, 0, 0, 5, 38
"c:\Users\Josh\repos\doughleap\frontend\src\app\shared\utils\authenticationService.ts", "TypeScript", 218, 0, 0, 0, 28, 25, 271
"c:\Users\Josh\repos\doughleap\frontend\src\app\shared\utils\filterService.ts", "TypeScript", 115, 0, 0, 0, 6, 7, 128
"c:\Users\Josh\repos\doughleap\frontend\src\app\shared\utils\formValidator.ts", "TypeScript", 42, 0, 0, 0, 0, 9, 51
"c:\Users\Josh\repos\doughleap\frontend\src\app\shared\utils\photoService.ts", "TypeScript", 23, 0, 0, 0, 0, 6, 29
"c:\Users\Josh\repos\doughleap\frontend\src\app\shared\utils\sortingService.ts", "TypeScript", 40, 0, 0, 0, 4, 7, 51
"c:\Users\Josh\repos\doughleap\frontend\src\app\shared\utils\supabase.service.ts", "TypeScript", 13, 0, 0, 0, 1, 3, 17
"c:\Users\Josh\repos\doughleap\frontend\src\app\shared\utils\types.ts", "TypeScript", 27, 0, 0, 0, 2, 2, 31
"Total", "-", 11166, 4596, 59, 8, 403, 1277, 17509