"filename", "language", "TypeScript", "HTML", "Draw.io", "SCSS", "comment", "blank", "total"
"c:\Users\Josh\repos\doughleap\frontend\src\app\account\feature\login\login-page.component.html", "HTML", 0, 85, 0, 0, 56, 10, 151
"c:\Users\Josh\repos\doughleap\frontend\src\app\account\feature\login\login-page.component.spec.ts", "TypeScript", 17, 0, 0, 0, 0, 5, 22
"c:\Users\Josh\repos\doughleap\frontend\src\app\account\feature\login\login-page.component.ts", "TypeScript", 57, 0, 0, 0, 3, 8, 68
"c:\Users\Josh\repos\doughleap\frontend\src\app\account\feature\password\password-reset-page.component.html", "HTML", 0, 1, 0, 0, 0, 1, 2
"c:\Users\Josh\repos\doughleap\frontend\src\app\account\feature\password\password-reset-page.component.ts", "TypeScript", 10, 0, 0, 0, 0, 3, 13
"c:\Users\Josh\repos\doughleap\frontend\src\app\account\feature\signup\signup-page.component.html", "HTML", 0, 102, 0, 0, 55, 8, 165
"c:\Users\Josh\repos\doughleap\frontend\src\app\account\feature\signup\signup-page.component.ts", "TypeScript", 89, 0, 0, 0, 0, 9, 98
"c:\Users\Josh\repos\doughleap\frontend\src\app\account\feature\verify\verify.component.html", "HTML", 0, 1, 0, 0, 0, 1, 2
"c:\Users\Josh\repos\doughleap\frontend\src\app\account\feature\verify\verify.component.ts", "TypeScript", 10, 0, 0, 0, 0, 3, 13
"c:\Users\Josh\repos\doughleap\frontend\src\app\app.component.html", "HTML", 0, 4, 0, 0, 0, 1, 5
"c:\Users\Josh\repos\doughleap\frontend\src\app\app.component.spec.ts", "TypeScript", 25, 0, 0, 0, 0, 5, 30
"c:\Users\Josh\repos\doughleap\frontend\src\app\app.component.ts", "TypeScript", 22, 0, 0, 0, 0, 3, 25
"c:\Users\Josh\repos\doughleap\frontend\src\app\guards\profile.guard.ts", "TypeScript", 30, 0, 0, 0, 3, 3, 36
"c:\Users\Josh\repos\doughleap\frontend\src\app\header\feature\app-header.component.html", "HTML", 0, 187, 0, 0, 3, 3, 193
"c:\Users\Josh\repos\doughleap\frontend\src\app\header\feature\app-header.component.ts", "TypeScript", 95, 0, 0, 0, 0, 12, 107
"c:\Users\Josh\repos\doughleap\frontend\src\app\home\home.component.html", "HTML", 0, 19, 0, 0, 0, 1, 20
"c:\Users\Josh\repos\doughleap\frontend\src\app\home\home.component.ts", "TypeScript", 31, 0, 0, 0, 1, 4, 36
"c:\Users\Josh\repos\doughleap\frontend\src\app\kitchen\feature\Inventory\feature\ingredient-inventory\data\ingredient-stock.service.ts", "TypeScript", 88, 0, 0, 0, 2, 10, 100
"c:\Users\Josh\repos\doughleap\frontend\src\app\kitchen\feature\Inventory\feature\ingredient-inventory\state\ingredient-stock-actions.ts", "TypeScript", 76, 0, 0, 0, 0, 5, 81
"c:\Users\Josh\repos\doughleap\frontend\src\app\kitchen\feature\Inventory\feature\ingredient-inventory\state\ingredient-stock-effects.ts", "TypeScript", 118, 0, 0, 0, 0, 7, 125
"c:\Users\Josh\repos\doughleap\frontend\src\app\kitchen\feature\Inventory\feature\ingredient-inventory\state\ingredient-stock-reducers.ts", "TypeScript", 115, 0, 0, 0, 0, 2, 117
"c:\Users\Josh\repos\doughleap\frontend\src\app\kitchen\feature\Inventory\feature\ingredient-inventory\state\ingredient-stock-selectors.ts", "TypeScript", 23, 0, 0, 0, 0, 9, 32
"c:\Users\Josh\repos\doughleap\frontend\src\app\kitchen\feature\Inventory\feature\ingredient-inventory\state\ingredient-stock-state.ts", "TypeScript", 29, 0, 0, 0, 0, 4, 33
"c:\Users\Josh\repos\doughleap\frontend\src\app\kitchen\feature\Inventory\feature\ingredient-inventory\ui\add-ingredient-stock-modal\add-ingredient-stock-modal.component.html", "HTML", 0, 128, 0, 0, 2, 5, 135
"c:\Users\Josh\repos\doughleap\frontend\src\app\kitchen\feature\Inventory\feature\ingredient-inventory\ui\add-ingredient-stock-modal\add-ingredient-stock-modal.component.ts", "TypeScript", 141, 0, 0, 0, 1, 16, 158
"c:\Users\Josh\repos\doughleap\frontend\src\app\kitchen\feature\Inventory\feature\ingredient-inventory\ui\delete-ingredient-stock-modal\delete-ingredient-stock-modal.component.html", "HTML", 0, 53, 0, 0, 0, 1, 54
"c:\Users\Josh\repos\doughleap\frontend\src\app\kitchen\feature\Inventory\feature\ingredient-inventory\ui\delete-ingredient-stock-modal\delete-ingredient-stock-modal.component.ts", "TypeScript", 53, 0, 0, 0, 1, 8, 62
"c:\Users\Josh\repos\doughleap\frontend\src\app\kitchen\feature\Inventory\feature\ingredient-inventory\ui\edit-ingredient-stock-modal\edit-ingredient-stock-modal.component.html", "HTML", 0, 114, 0, 0, 2, 4, 120
"c:\Users\Josh\repos\doughleap\frontend\src\app\kitchen\feature\Inventory\feature\ingredient-inventory\ui\edit-ingredient-stock-modal\edit-ingredient-stock-modal.component.ts", "TypeScript", 154, 0, 0, 0, 0, 19, 173
"c:\Users\Josh\repos\doughleap\frontend\src\app\kitchen\feature\Inventory\feature\tool-inventory\data\tool-stock.service.ts", "TypeScript", 72, 0, 0, 0, 1, 10, 83
"c:\Users\Josh\repos\doughleap\frontend\src\app\kitchen\feature\Inventory\feature\tool-inventory\state\tool-stock-actions.ts", "TypeScript", 76, 0, 0, 0, 0, 5, 81
"c:\Users\Josh\repos\doughleap\frontend\src\app\kitchen\feature\Inventory\feature\tool-inventory\state\tool-stock-effects.ts", "TypeScript", 126, 0, 0, 0, 0, 7, 133
"c:\Users\Josh\repos\doughleap\frontend\src\app\kitchen\feature\Inventory\feature\tool-inventory\state\tool-stock-reducers.ts", "TypeScript", 125, 0, 0, 0, 0, 3, 128
"c:\Users\Josh\repos\doughleap\frontend\src\app\kitchen\feature\Inventory\feature\tool-inventory\state\tool-stock-selectors.ts", "TypeScript", 28, 0, 0, 0, 0, 9, 37
"c:\Users\Josh\repos\doughleap\frontend\src\app\kitchen\feature\Inventory\feature\tool-inventory\state\tool-stock-state.ts", "TypeScript", 27, 0, 0, 0, 0, 3, 30
"c:\Users\Josh\repos\doughleap\frontend\src\app\kitchen\feature\Inventory\feature\tool-inventory\ui\add-tool-stock-modal\add-tool-stock-modal.component.html", "HTML", 0, 99, 0, 0, 2, 4, 105
"c:\Users\Josh\repos\doughleap\frontend\src\app\kitchen\feature\Inventory\feature\tool-inventory\ui\add-tool-stock-modal\add-tool-stock-modal.component.ts", "TypeScript", 122, 0, 0, 0, 1, 14, 137
"c:\Users\Josh\repos\doughleap\frontend\src\app\kitchen\feature\Inventory\feature\tool-inventory\ui\delete-tool-stock-modal\delete-tool-stock-modal.component.html", "HTML", 0, 53, 0, 0, 0, 1, 54
"c:\Users\Josh\repos\doughleap\frontend\src\app\kitchen\feature\Inventory\feature\tool-inventory\ui\delete-tool-stock-modal\delete-tool-stock-modal.component.ts", "TypeScript", 53, 0, 0, 0, 1, 7, 61
"c:\Users\Josh\repos\doughleap\frontend\src\app\kitchen\feature\Inventory\feature\tool-inventory\ui\edit-tool-stock-modal\edit-tool-stock-modal.component.html", "HTML", 0, 87, 0, 0, 2, 3, 92
"c:\Users\Josh\repos\doughleap\frontend\src\app\kitchen\feature\Inventory\feature\tool-inventory\ui\edit-tool-stock-modal\edit-tool-stock-modal.component.ts", "TypeScript", 128, 0, 0, 0, 0, 16, 144
"c:\Users\Josh\repos\doughleap\frontend\src\app\kitchen\feature\ingredients\data\ingredient.service.ts", "TypeScript", 99, 0, 0, 0, 1, 15, 115
"c:\Users\Josh\repos\doughleap\frontend\src\app\kitchen\feature\ingredients\ingredients.component.html", "HTML", 0, 127, 0, 0, 9, 7, 143
"c:\Users\Josh\repos\doughleap\frontend\src\app\kitchen\feature\ingredients\ingredients.component.ts", "TypeScript", 202, 0, 0, 0, 3, 24, 229
"c:\Users\Josh\repos\doughleap\frontend\src\app\kitchen\feature\ingredients\state\ingredient-actions.ts", "TypeScript", 76, 0, 0, 0, 0, 5, 81
"c:\Users\Josh\repos\doughleap\frontend\src\app\kitchen\feature\ingredients\state\ingredient-effects.ts", "TypeScript", 120, 0, 0, 0, 0, 10, 130
"c:\Users\Josh\repos\doughleap\frontend\src\app\kitchen\feature\ingredients\state\ingredient-reducers.ts", "TypeScript", 101, 0, 0, 0, 0, 3, 104
"c:\Users\Josh\repos\doughleap\frontend\src\app\kitchen\feature\ingredients\state\ingredient-selectors.ts", "TypeScript", 13, 0, 0, 0, 0, 7, 20
"c:\Users\Josh\repos\doughleap\frontend\src\app\kitchen\feature\ingredients\state\ingredient-state.ts", "TypeScript", 23, 0, 0, 0, 0, 3, 26
"c:\Users\Josh\repos\doughleap\frontend\src\app\kitchen\feature\ingredients\ui\add-ingredient-modal\add-ingredient-modal.component.html", "HTML", 0, 124, 0, 0, 2, 7, 133
"c:\Users\Josh\repos\doughleap\frontend\src\app\kitchen\feature\ingredients\ui\add-ingredient-modal\add-ingredient-modal.component.ts", "TypeScript", 110, 0, 0, 0, 0, 11, 121
"c:\Users\Josh\repos\doughleap\frontend\src\app\kitchen\feature\ingredients\ui\delete-ingredient-modal\delete-ingredient-modal.component.html", "HTML", 0, 48, 0, 0, 0, 1, 49
"c:\Users\Josh\repos\doughleap\frontend\src\app\kitchen\feature\ingredients\ui\delete-ingredient-modal\delete-ingredient-modal.component.ts", "TypeScript", 53, 0, 0, 0, 1, 8, 62
"c:\Users\Josh\repos\doughleap\frontend\src\app\kitchen\feature\ingredients\ui\edit-ingredient-modal\edit-ingredient-modal.component.html", "HTML", 0, 123, 0, 0, 2, 6, 131
"c:\Users\Josh\repos\doughleap\frontend\src\app\kitchen\feature\ingredients\ui\edit-ingredient-modal\edit-ingredient-modal.component.ts", "TypeScript", 159, 0, 0, 0, 0, 14, 173
"c:\Users\Josh\repos\doughleap\frontend\src\app\kitchen\feature\ingredients\ui\ingredient-details-modal\ingredient-details-modal.component.html", "HTML", 0, 154, 0, 0, 7, 5, 166
"c:\Users\Josh\repos\doughleap\frontend\src\app\kitchen\feature\ingredients\ui\ingredient-details-modal\ingredient-details-modal.component.ts", "TypeScript", 245, 0, 0, 0, 3, 24, 272
"c:\Users\Josh\repos\doughleap\frontend\src\app\kitchen\feature\tools\data\tool.service.ts", "TypeScript", 81, 0, 0, 0, 0, 13, 94
"c:\Users\Josh\repos\doughleap\frontend\src\app\kitchen\feature\tools\state\tool-actions.ts", "TypeScript", 76, 0, 0, 0, 0, 7, 83
"c:\Users\Josh\repos\doughleap\frontend\src\app\kitchen\feature\tools\state\tool-effects.ts", "TypeScript", 126, 0, 0, 0, 0, 6, 132
"c:\Users\Josh\repos\doughleap\frontend\src\app\kitchen\feature\tools\state\tool-reducers.ts", "TypeScript", 98, 0, 0, 0, 0, 2, 100
"c:\Users\Josh\repos\doughleap\frontend\src\app\kitchen\feature\tools\state\tool-selectors.ts", "TypeScript", 13, 0, 0, 0, 0, 8, 21
"c:\Users\Josh\repos\doughleap\frontend\src\app\kitchen\feature\tools\state\tool-state.ts", "TypeScript", 20, 0, 0, 0, 0, 2, 22
"c:\Users\Josh\repos\doughleap\frontend\src\app\kitchen\feature\tools\tools.component.html", "HTML", 0, 127, 0, 0, 9, 7, 143
"c:\Users\Josh\repos\doughleap\frontend\src\app\kitchen\feature\tools\tools.component.ts", "TypeScript", 192, 0, 0, 0, 2, 24, 218
"c:\Users\Josh\repos\doughleap\frontend\src\app\kitchen\feature\tools\ui\add-tool-modal\add-tool-modal.component.html", "HTML", 0, 92, 0, 0, 2, 4, 98
"c:\Users\Josh\repos\doughleap\frontend\src\app\kitchen\feature\tools\ui\add-tool-modal\add-tool-modal.component.ts", "TypeScript", 94, 0, 0, 0, 0, 10, 104
"c:\Users\Josh\repos\doughleap\frontend\src\app\kitchen\feature\tools\ui\delete-tool-modal\delete-tool-modal.component.html", "HTML", 0, 48, 0, 0, 0, 1, 49
"c:\Users\Josh\repos\doughleap\frontend\src\app\kitchen\feature\tools\ui\delete-tool-modal\delete-tool-modal.component.ts", "TypeScript", 53, 0, 0, 0, 1, 7, 61
"c:\Users\Josh\repos\doughleap\frontend\src\app\kitchen\feature\tools\ui\edit-tool-modal\edit-tool-modal.component.html", "HTML", 0, 84, 0, 0, 2, 3, 89
"c:\Users\Josh\repos\doughleap\frontend\src\app\kitchen\feature\tools\ui\edit-tool-modal\edit-tool-modal.component.ts", "TypeScript", 108, 0, 0, 0, 0, 15, 123
"c:\Users\Josh\repos\doughleap\frontend\src\app\kitchen\feature\tools\ui\tool-details-modal\tool-details-modal.component.html", "HTML", 0, 143, 0, 0, 7, 5, 155
"c:\Users\Josh\repos\doughleap\frontend\src\app\kitchen\feature\tools\ui\tool-details-modal\tool-details-modal.component.ts", "TypeScript", 240, 0, 0, 0, 3, 25, 268
"c:\Users\Josh\repos\doughleap\frontend\src\app\kitchen\kitchen-page.component.html", "HTML", 0, 29, 0, 0, 3, 2, 34
"c:\Users\Josh\repos\doughleap\frontend\src\app\kitchen\kitchen-page.component.ts", "TypeScript", 26, 0, 0, 0, 0, 6, 32
"c:\Users\Josh\repos\doughleap\frontend\src\app\kitchen\state\kitchen-actions.ts", "TypeScript", 16, 0, 0, 0, 0, 3, 19
"c:\Users\Josh\repos\doughleap\frontend\src\app\kitchen\state\kitchen-interfaces.ts", "TypeScript", 16, 0, 0, 0, 0, 2, 18
"c:\Users\Josh\repos\doughleap\frontend\src\app\kitchen\state\kitchen-reducers.ts", "TypeScript", 18, 0, 0, 0, 1, 4, 23
"c:\Users\Josh\repos\doughleap\frontend\src\app\kitchen\state\kitchen-selectors.ts", "TypeScript", 6, 0, 0, 0, 0, 2, 8
"c:\Users\Josh\repos\doughleap\frontend\src\app\kitchen\state\kitchen-state.ts", "TypeScript", 4, 0, 0, 0, 0, 0, 4
"c:\Users\Josh\repos\doughleap\frontend\src\app\profile\data\profile.service.ts", "TypeScript", 58, 0, 0, 0, 0, 13, 71
"c:\Users\Josh\repos\doughleap\frontend\src\app\profile\profile.component.html", "HTML", 0, 230, 0, 0, 14, 10, 254
"c:\Users\Josh\repos\doughleap\frontend\src\app\profile\profile.component.ts", "TypeScript", 113, 0, 0, 0, 1, 12, 126
"c:\Users\Josh\repos\doughleap\frontend\src\app\profile\state\profile-actions.ts", "TypeScript", 124, 0, 0, 0, 0, 12, 136
"c:\Users\Josh\repos\doughleap\frontend\src\app\profile\state\profile-effects.ts", "TypeScript", 130, 0, 0, 0, 35, 14, 179
"c:\Users\Josh\repos\doughleap\frontend\src\app\profile\state\profile-reducers.ts", "TypeScript", 184, 0, 0, 0, 0, 2, 186
"c:\Users\Josh\repos\doughleap\frontend\src\app\profile\state\profile-selectors.ts", "TypeScript", 24, 0, 0, 0, 0, 16, 40
"c:\Users\Josh\repos\doughleap\frontend\src\app\profile\state\profile-state.ts", "TypeScript", 38, 0, 0, 0, 0, 3, 41
"c:\Users\Josh\repos\doughleap\frontend\src\app\profile\ui\edit-photo-modal\edit-photo-modal.component.html", "HTML", 0, 69, 0, 0, 2, 4, 75
"c:\Users\Josh\repos\doughleap\frontend\src\app\profile\ui\edit-photo-modal\edit-photo-modal.component.ts", "TypeScript", 149, 0, 0, 0, 8, 13, 170
"c:\Users\Josh\repos\doughleap\frontend\src\app\profile\ui\edit-profile-modal\edit-profile-modal.component.html", "HTML", 0, 81, 0, 0, 2, 3, 86
"c:\Users\Josh\repos\doughleap\frontend\src\app\profile\ui\edit-profile-modal\edit-profile-modal.component.ts", "TypeScript", 83, 0, 0, 0, 0, 8, 91
"c:\Users\Josh\repos\doughleap\frontend\src\app\recipes\data\recipe-category.service.ts", "TypeScript", 35, 0, 0, 0, 0, 6, 41
"c:\Users\Josh\repos\doughleap\frontend\src\app\recipes\data\recipe-ingredients.service.ts", "TypeScript", 70, 0, 0, 0, 0, 10, 80
"c:\Users\Josh\repos\doughleap\frontend\src\app\recipes\data\recipe-step.service.ts", "TypeScript", 61, 0, 0, 0, 0, 10, 71
"c:\Users\Josh\repos\doughleap\frontend\src\app\recipes\data\recipe-tool.service.ts", "TypeScript", 61, 0, 0, 0, 0, 10, 71
"c:\Users\Josh\repos\doughleap\frontend\src\app\recipes\data\recipe.service.ts", "TypeScript", 247, 0, 0, 0, 1, 22, 270
"c:\Users\Josh\repos\doughleap\frontend\src\app\recipes\data\step.service.ts", "TypeScript", 50, 0, 0, 0, 0, 9, 59
"c:\Users\Josh\repos\doughleap\frontend\src\app\recipes\feature\recipe\public-recipe\public-recipe.component.html", "HTML", 0, 167, 0, 0, 7, 6, 180
"c:\Users\Josh\repos\doughleap\frontend\src\app\recipes\feature\recipe\public-recipe\public-recipe.component.ts", "TypeScript", 240, 0, 0, 0, 0, 13, 253
"c:\Users\Josh\repos\doughleap\frontend\src\app\recipes\feature\recipe\recipe.component.html", "HTML", 0, 427, 0, 0, 12, 9, 448
"c:\Users\Josh\repos\doughleap\frontend\src\app\recipes\feature\recipe\ui\delete-recipe-modal\delete-recipe-modal.component.html", "HTML", 0, 48, 0, 0, 0, 1, 49
"c:\Users\Josh\repos\doughleap\frontend\src\app\recipes\feature\recipe\ui\delete-recipe-modal\delete-recipe-modal.component.ts", "TypeScript", 56, 0, 0, 0, 1, 8, 65
"c:\Users\Josh\repos\doughleap\frontend\src\app\recipes\feature\recipe\ui\edit-recipe-modal\edit-recipe-modal.component.html", "HTML", 0, 209, 0, 0, 2, 4, 215
"c:\Users\Josh\repos\doughleap\frontend\src\app\recipes\feature\recipe\ui\edit-recipe-modal\edit-recipe-modal.component.ts", "TypeScript", 227, 0, 0, 0, 7, 18, 252
"c:\Users\Josh\repos\doughleap\frontend\src\app\recipes\feature\recipe\ui\recipe-shopping-list-modal\recipe-shopping-list-modal.component.html", "HTML", 0, 43, 0, 0, 2, 2, 47
"c:\Users\Josh\repos\doughleap\frontend\src\app\recipes\feature\recipe\ui\recipe-shopping-list-modal\recipe-shopping-list-modal.component.ts", "TypeScript", 31, 0, 0, 0, 0, 5, 36
"c:\Users\Josh\repos\doughleap\frontend\src\app\recipes\feature\recipe\ui\subscribe-recipe-modal\subscribe-recipe-modal.component.html", "HTML", 0, 197, 0, 0, 11, 6, 214
"c:\Users\Josh\repos\doughleap\frontend\src\app\recipes\feature\recipe\ui\subscribe-recipe-modal\subscribe-recipe-modal.component.ts", "TypeScript", 247, 0, 0, 0, 11, 24, 282
"c:\Users\Josh\repos\doughleap\frontend\src\app\recipes\feature\recipe\ui\unsubscribe-recipe-modal\unsubscribe-recipe-modal.component.html", "HTML", 0, 48, 0, 0, 0, 1, 49
"c:\Users\Josh\repos\doughleap\frontend\src\app\recipes\feature\recipe\ui\unsubscribe-recipe-modal\unsubscribe-recipe-modal.component.ts", "TypeScript", 58, 0, 0, 0, 0, 9, 67
"c:\Users\Josh\repos\doughleap\frontend\src\app\recipes\feature\recipe\ui\use-recipe-modal\use-recipe-modal.component.html", "HTML", 0, 90, 0, 0, 3, 7, 100
"c:\Users\Josh\repos\doughleap\frontend\src\app\recipes\feature\recipe\ui\use-recipe-modal\use-recipe-modal.component.ts", "TypeScript", 107, 0, 0, 0, 4, 10, 121
"c:\Users\Josh\repos\doughleap\frontend\src\app\recipes\feature\recipe\user-recipe\user-recipe.component.html", "HTML", 0, 509, 0, 0, 12, 7, 528
"c:\Users\Josh\repos\doughleap\frontend\src\app\recipes\feature\recipe\user-recipe\user-recipe.component.ts", "TypeScript", 584, 0, 0, 0, 12, 25, 621
"c:\Users\Josh\repos\doughleap\frontend\src\app\recipes\feature\recipes-page\feature\discover\discover-recipes.component.html", "HTML", 0, 1, 0, 0, 0, 1, 2
"c:\Users\Josh\repos\doughleap\frontend\src\app\recipes\feature\recipes-page\feature\discover\discover-recipes.component.ts", "TypeScript", 9, 0, 0, 0, 0, 2, 11
"c:\Users\Josh\repos\doughleap\frontend\src\app\recipes\feature\recipes-page\feature\list\recipe-list.component.html", "HTML", 0, 103, 0, 0, 5, 3, 111
"c:\Users\Josh\repos\doughleap\frontend\src\app\recipes\feature\recipes-page\feature\list\recipe-list.component.ts", "TypeScript", 273, 0, 0, 0, 5, 12, 290
"c:\Users\Josh\repos\doughleap\frontend\src\app\recipes\feature\recipes-page\recipes-page.component-new.html", "HTML", 0, 42, 0, 0, 2, 1, 45
"c:\Users\Josh\repos\doughleap\frontend\src\app\recipes\feature\recipes-page\recipes-page.component-new.ts", "TypeScript", 42, 0, 0, 0, 0, 4, 46
"c:\Users\Josh\repos\doughleap\frontend\src\app\recipes\feature\recipes-page\recipes-page.component.html", "HTML", 0, 413, 0, 0, 13, 11, 437
"c:\Users\Josh\repos\doughleap\frontend\src\app\recipes\feature\recipes-page\recipes-page.component.scss", "SCSS", 0, 0, 0, 8, 0, 1, 9
"c:\Users\Josh\repos\doughleap\frontend\src\app\recipes\feature\recipes-page\recipes-page.component.ts", "TypeScript", 625, 0, 0, 0, 20, 49, 694
"c:\Users\Josh\repos\doughleap\frontend\src\app\recipes\feature\recipes-page\test.drawio", "Draw.io", 0, 0, 59, 0, 0, 0, 59
"c:\Users\Josh\repos\doughleap\frontend\src\app\recipes\feature\recipes-page\ui\recipe-category\recipe-category-card\recipe-category-card.component.html", "HTML", 0, 36, 0, 0, 0, 2, 38
"c:\Users\Josh\repos\doughleap\frontend\src\app\recipes\feature\recipes-page\ui\recipe-category\recipe-category-card\recipe-category-card.component.ts", "TypeScript", 20, 0, 0, 0, 0, 3, 23
"c:\Users\Josh\repos\doughleap\frontend\src\app\recipes\feature\recipes-page\ui\recipe-ingredient\add-recipe-ingredient-modal\add-recipe-ingredient-modal.component.html", "HTML", 0, 152, 0, 0, 2, 3, 157
"c:\Users\Josh\repos\doughleap\frontend\src\app\recipes\feature\recipes-page\ui\recipe-ingredient\add-recipe-ingredient-modal\add-recipe-ingredient-modal.component.ts", "TypeScript", 181, 0, 0, 0, 4, 16, 201
"c:\Users\Josh\repos\doughleap\frontend\src\app\recipes\feature\recipes-page\ui\recipe-ingredient\delete-recipe-ingredient-modal\delete-recipe-ingredient-modal.component.html", "HTML", 0, 48, 0, 0, 0, 1, 49
"c:\Users\Josh\repos\doughleap\frontend\src\app\recipes\feature\recipes-page\ui\recipe-ingredient\delete-recipe-ingredient-modal\delete-recipe-ingredient-modal.component.ts", "TypeScript", 60, 0, 0, 0, 1, 7, 68
"c:\Users\Josh\repos\doughleap\frontend\src\app\recipes\feature\recipes-page\ui\recipe-ingredient\recipe-ingredients-modal\recipe-ingredients-modal.component.html", "HTML", 0, 102, 0, 0, 2, 3, 107
"c:\Users\Josh\repos\doughleap\frontend\src\app\recipes\feature\recipes-page\ui\recipe-ingredient\recipe-ingredients-modal\recipe-ingredients-modal.component.ts", "TypeScript", 211, 0, 0, 0, 6, 19, 236
"c:\Users\Josh\repos\doughleap\frontend\src\app\recipes\feature\recipes-page\ui\recipe-step\add-recipe-step-modal\add-recipe-step-modal.component.html", "HTML", 0, 127, 0, 0, 2, 4, 133
"c:\Users\Josh\repos\doughleap\frontend\src\app\recipes\feature\recipes-page\ui\recipe-step\add-recipe-step-modal\add-recipe-step-modal.component.ts", "TypeScript", 162, 0, 0, 0, 2, 20, 184
"c:\Users\Josh\repos\doughleap\frontend\src\app\recipes\feature\recipes-page\ui\recipe-step\delete-recipe-step-modal\delete-recipe-step-modal.component.html", "HTML", 0, 48, 0, 0, 0, 1, 49
"c:\Users\Josh\repos\doughleap\frontend\src\app\recipes\feature\recipes-page\ui\recipe-step\delete-recipe-step-modal\delete-recipe-step-modal.component.ts", "TypeScript", 63, 0, 0, 0, 1, 8, 72
"c:\Users\Josh\repos\doughleap\frontend\src\app\recipes\feature\recipes-page\ui\recipe-step\edit-recipe-step-modal\edit-recipe-step-modal.component.html", "HTML", 0, 107, 0, 0, 2, 4, 113
"c:\Users\Josh\repos\doughleap\frontend\src\app\recipes\feature\recipes-page\ui\recipe-step\edit-recipe-step-modal\edit-recipe-step-modal.component.ts", "TypeScript", 196, 0, 0, 0, 9, 17, 222
"c:\Users\Josh\repos\doughleap\frontend\src\app\recipes\feature\recipes-page\ui\recipe-step\recipe-steps-modal\recipe-steps-modal.component.html", "HTML", 0, 145, 0, 0, 2, 5, 152
"c:\Users\Josh\repos\doughleap\frontend\src\app\recipes\feature\recipes-page\ui\recipe-step\recipe-steps-modal\recipe-steps-modal.component.ts", "TypeScript", 501, 0, 0, 0, 25, 53, 579
"c:\Users\Josh\repos\doughleap\frontend\src\app\recipes\feature\recipes-page\ui\recipe-tool\add-recipe-tool-modal\add-recipe-tool-modal.component.html", "HTML", 0, 111, 0, 0, 2, 3, 116
"c:\Users\Josh\repos\doughleap\frontend\src\app\recipes\feature\recipes-page\ui\recipe-tool\add-recipe-tool-modal\add-recipe-tool-modal.component.ts", "TypeScript", 108, 0, 0, 0, 0, 10, 118
"c:\Users\Josh\repos\doughleap\frontend\src\app\recipes\feature\recipes-page\ui\recipe-tool\delete-recipe-tool-modal\delete-recipe-tool-modal.component.html", "HTML", 0, 51, 0, 0, 0, 1, 52
"c:\Users\Josh\repos\doughleap\frontend\src\app\recipes\feature\recipes-page\ui\recipe-tool\delete-recipe-tool-modal\delete-recipe-tool-modal.component.ts", "TypeScript", 67, 0, 0, 0, 1, 7, 75
"c:\Users\Josh\repos\doughleap\frontend\src\app\recipes\feature\recipes-page\ui\recipe-tool\recipe-tools-modal\recipe-tools-modal.component.html", "HTML", 0, 97, 0, 0, 2, 3, 102
"c:\Users\Josh\repos\doughleap\frontend\src\app\recipes\feature\recipes-page\ui\recipe-tool\recipe-tools-modal\recipe-tools-modal.component.ts", "TypeScript", 228, 0, 0, 0, 2, 18, 248
"c:\Users\Josh\repos\doughleap\frontend\src\app\recipes\feature\recipes-page\ui\recipe\add-recipe-modal\add-recipe-modal.component.html", "HTML", 0, 226, 0, 0, 8, 4, 238
"c:\Users\Josh\repos\doughleap\frontend\src\app\recipes\feature\recipes-page\ui\recipe\add-recipe-modal\add-recipe-modal.component.ts", "TypeScript", 186, 0, 0, 0, 2, 20, 208
"c:\Users\Josh\repos\doughleap\frontend\src\app\recipes\feature\recipes-page\ui\recipe\recipe-card\recipe-card.component.html", "HTML", 0, 42, 0, 0, 0, 1, 43
"c:\Users\Josh\repos\doughleap\frontend\src\app\recipes\feature\recipes-page\ui\recipe\recipe-card\recipe-card.component.ts", "TypeScript", 22, 0, 0, 0, 0, 4, 26
"c:\Users\Josh\repos\doughleap\frontend\src\app\recipes\feature\recipes-page\ui\recipes-info\recipes-info.component.html", "HTML", 0, 4, 0, 0, 0, 1, 5
"c:\Users\Josh\repos\doughleap\frontend\src\app\recipes\feature\recipes-page\ui\recipes-info\recipes-info.component.ts", "TypeScript", 10, 0, 0, 0, 0, 3, 13
"c:\Users\Josh\repos\doughleap\frontend\src\app\recipes\state\recipe-category\recipe-category-actions.ts", "TypeScript", 31, 0, 0, 0, 0, 5, 36
"c:\Users\Josh\repos\doughleap\frontend\src\app\recipes\state\recipe-category\recipe-category-effects.ts", "TypeScript", 39, 0, 0, 0, 0, 4, 43
"c:\Users\Josh\repos\doughleap\frontend\src\app\recipes\state\recipe-category\recipe-category-reducers.ts", "TypeScript", 56, 0, 0, 0, 0, 3, 59
"c:\Users\Josh\repos\doughleap\frontend\src\app\recipes\state\recipe-category\recipe-category-selectors.ts", "TypeScript", 17, 0, 0, 0, 0, 8, 25
"c:\Users\Josh\repos\doughleap\frontend\src\app\recipes\state\recipe-category\recipe-category-state.ts", "TypeScript", 20, 0, 0, 0, 0, 2, 22
"c:\Users\Josh\repos\doughleap\frontend\src\app\recipes\state\recipe-ingredient\recipe-ingredient-actions.ts", "TypeScript", 76, 0, 0, 0, 0, 7, 83
"c:\Users\Josh\repos\doughleap\frontend\src\app\recipes\state\recipe-ingredient\recipe-ingredient-effects.ts", "TypeScript", 196, 0, 0, 0, 0, 8, 204
"c:\Users\Josh\repos\doughleap\frontend\src\app\recipes\state\recipe-ingredient\recipe-ingredient-reducers.ts", "TypeScript", 134, 0, 0, 0, 0, 4, 138
"c:\Users\Josh\repos\doughleap\frontend\src\app\recipes\state\recipe-ingredient\recipe-ingredient-selectors.ts", "TypeScript", 30, 0, 0, 0, 1, 10, 41
"c:\Users\Josh\repos\doughleap\frontend\src\app\recipes\state\recipe-ingredient\recipe-ingredient-state.ts", "TypeScript", 22, 0, 0, 0, 0, 2, 24
"c:\Users\Josh\repos\doughleap\frontend\src\app\recipes\state\recipe-page-actions.ts", "TypeScript", 8, 0, 0, 0, 0, 1, 9
"c:\Users\Josh\repos\doughleap\frontend\src\app\recipes\state\recipe-page-reducers.ts", "TypeScript", 10, 0, 0, 0, 0, 2, 12
"c:\Users\Josh\repos\doughleap\frontend\src\app\recipes\state\recipe-page-selectors.ts", "TypeScript", 4, 0, 0, 0, 0, 2, 6
"c:\Users\Josh\repos\doughleap\frontend\src\app\recipes\state\recipe-page-state.ts", "TypeScript", 3, 0, 0, 0, 0, 0, 3
"c:\Users\Josh\repos\doughleap\frontend\src\app\recipes\state\recipe-step\recipe-step-actions.ts", "TypeScript", 36, 0, 0, 0, 0, 8, 44
"c:\Users\Josh\repos\doughleap\frontend\src\app\recipes\state\recipe-step\recipe-step-effects.ts", "TypeScript", 195, 0, 0, 0, 45, 9, 249
"c:\Users\Josh\repos\doughleap\frontend\src\app\recipes\state\recipe-step\recipe-step-reducers.ts", "TypeScript", 98, 0, 0, 0, 0, 2, 100
"c:\Users\Josh\repos\doughleap\frontend\src\app\recipes\state\recipe-step\recipe-step-selectors.ts", "TypeScript", 18, 0, 0, 0, 0, 8, 26
"c:\Users\Josh\repos\doughleap\frontend\src\app\recipes\state\recipe-step\recipe-step-state.ts", "TypeScript", 21, 0, 0, 0, 0, 3, 24
"c:\Users\Josh\repos\doughleap\frontend\src\app\recipes\state\recipe-tool\recipe-tool-actions.ts", "TypeScript", 76, 0, 0, 0, 0, 6, 82
"c:\Users\Josh\repos\doughleap\frontend\src\app\recipes\state\recipe-tool\recipe-tool-effects.ts", "TypeScript", 185, 0, 0, 0, 0, 7, 192
"c:\Users\Josh\repos\doughleap\frontend\src\app\recipes\state\recipe-tool\recipe-tool-reducers.ts", "TypeScript", 133, 0, 0, 0, 0, 5, 138
"c:\Users\Josh\repos\doughleap\frontend\src\app\recipes\state\recipe-tool\recipe-tool-selectors.ts", "TypeScript", 34, 0, 0, 0, 1, 10, 45
"c:\Users\Josh\repos\doughleap\frontend\src\app\recipes\state\recipe-tool\recipe-tool-state.ts", "TypeScript", 20, 0, 0, 0, 0, 3, 23
"c:\Users\Josh\repos\doughleap\frontend\src\app\recipes\state\recipe\recipe-actions.ts", "TypeScript", 105, 0, 0, 0, 0, 10, 115
"c:\Users\Josh\repos\doughleap\frontend\src\app\recipes\state\recipe\recipe-effects.ts", "TypeScript", 198, 0, 0, 0, 0, 9, 207
"c:\Users\Josh\repos\doughleap\frontend\src\app\recipes\state\recipe\recipe-reducers.ts", "TypeScript", 139, 0, 0, 0, 0, 4, 143
"c:\Users\Josh\repos\doughleap\frontend\src\app\recipes\state\recipe\recipe-selectors.ts", "TypeScript", 36, 0, 0, 0, 0, 11, 47
"c:\Users\Josh\repos\doughleap\frontend\src\app\recipes\state\recipe\recipe-state.ts", "TypeScript", 73, 0, 0, 0, 1, 13, 87
"c:\Users\Josh\repos\doughleap\frontend\src\app\recipes\state\step\step-actions.ts", "TypeScript", 34, 0, 0, 0, 0, 6, 40
"c:\Users\Josh\repos\doughleap\frontend\src\app\recipes\state\step\step-effects.ts", "TypeScript", 121, 0, 0, 0, 0, 6, 127
"c:\Users\Josh\repos\doughleap\frontend\src\app\recipes\state\step\step-reducers.ts", "TypeScript", 93, 0, 0, 0, 0, 2, 95
"c:\Users\Josh\repos\doughleap\frontend\src\app\recipes\state\step\step-selectors.ts", "TypeScript", 19, 0, 0, 0, 0, 9, 28
"c:\Users\Josh\repos\doughleap\frontend\src\app\recipes\state\step\step-state.ts", "TypeScript", 19, 0, 0, 0, 0, 2, 21
"c:\Users\Josh\repos\doughleap\frontend\src\app\routes.ts", "TypeScript", 80, 0, 0, 0, 0, 2, 82
"c:\Users\Josh\repos\doughleap\frontend\src\app\shared\state\app-state.ts", "TypeScript", 8, 0, 0, 0, 0, 2, 10
"c:\Users\Josh\repos\doughleap\frontend\src\app\shared\state\shared-actions.ts", "TypeScript", 2, 0, 0, 0, 0, 2, 4
"c:\Users\Josh\repos\doughleap\frontend\src\app\shared\state\shared-reducers.ts", "TypeScript", 10, 0, 0, 0, 0, 3, 13
"c:\Users\Josh\repos\doughleap\frontend\src\app\shared\state\shared-selectors.ts", "TypeScript", 5, 0, 0, 0, 0, 3, 8
"c:\Users\Josh\repos\doughleap\frontend\src\app\shared\state\shared-state.ts", "TypeScript", 67, 0, 0, 0, 0, 6, 73
"c:\Users\Josh\repos\doughleap\frontend\src\app\shared\ui\add-request-confirmation\add-request-confirmation-modal.component.html", "HTML", 0, 22, 0, 0, 0, 0, 22
"c:\Users\Josh\repos\doughleap\frontend\src\app\shared\ui\add-request-confirmation\add-request-confirmation-modal.component.ts", "TypeScript", 21, 0, 0, 0, 0, 4, 25
"c:\Users\Josh\repos\doughleap\frontend\src\app\shared\ui\add-request-error\add-request-error-modal.component.html", "HTML", 0, 22, 0, 0, 5, 0, 27
"c:\Users\Josh\repos\doughleap\frontend\src\app\shared\ui\add-request-error\add-request-error-modal.component.ts", "TypeScript", 21, 0, 0, 0, 0, 4, 25
"c:\Users\Josh\repos\doughleap\frontend\src\app\shared\ui\app-notfound\app-notfound.component.html", "HTML", 0, 1, 0, 0, 0, 1, 2
"c:\Users\Josh\repos\doughleap\frontend\src\app\shared\ui\app-notfound\app-notfound.component.ts", "TypeScript", 10, 0, 0, 0, 0, 3, 13
"c:\Users\Josh\repos\doughleap\frontend\src\app\shared\ui\delete-request-confirmation\delete-request-confirmation-modal.component.html", "HTML", 0, 22, 0, 0, 0, 0, 22
"c:\Users\Josh\repos\doughleap\frontend\src\app\shared\ui\delete-request-confirmation\delete-request-confirmation-modal.component.ts", "TypeScript", 19, 0, 0, 0, 0, 4, 23
"c:\Users\Josh\repos\doughleap\frontend\src\app\shared\ui\delete-request-error\delete-request-error-modal.component.html", "HTML", 0, 22, 0, 0, 0, 0, 22
"c:\Users\Josh\repos\doughleap\frontend\src\app\shared\ui\delete-request-error\delete-request-error-modal.component.ts", "TypeScript", 19, 0, 0, 0, 0, 3, 22
"c:\Users\Josh\repos\doughleap\frontend\src\app\shared\ui\dl-table-full-filters\dl-table-full-filters.component.html", "HTML", 0, 170, 0, 0, 2, 2, 174
"c:\Users\Josh\repos\doughleap\frontend\src\app\shared\ui\dl-table-full-filters\dl-table-full-filters.component.ts", "TypeScript", 178, 0, 0, 0, 2, 21, 201
"c:\Users\Josh\repos\doughleap\frontend\src\app\shared\ui\dl-table-full\dl-table-full.component.html", "HTML", 0, 179, 0, 0, 1, 1, 181
"c:\Users\Josh\repos\doughleap\frontend\src\app\shared\ui\dl-table-full\dl-table-full.component.ts", "TypeScript", 314, 0, 0, 0, 6, 25, 345
"c:\Users\Josh\repos\doughleap\frontend\src\app\shared\ui\filterModals\currency-filter-modal\currency-filter-modal.component.html", "HTML", 0, 1, 0, 0, 0, 1, 2
"c:\Users\Josh\repos\doughleap\frontend\src\app\shared\ui\filterModals\currency-filter-modal\currency-filter-modal.component.ts", "TypeScript", 10, 0, 0, 0, 0, 3, 13
"c:\Users\Josh\repos\doughleap\frontend\src\app\shared\ui\filterModals\date-filter-modal\date-filter-modal.component.html", "HTML", 0, 104, 0, 0, 2, 2, 108
"c:\Users\Josh\repos\doughleap\frontend\src\app\shared\ui\filterModals\date-filter-modal\date-filter-modal.component.ts", "TypeScript", 131, 0, 0, 0, 3, 11, 145
"c:\Users\Josh\repos\doughleap\frontend\src\app\shared\ui\filterModals\numeric-filter-modal\numeric-filter-modal.component.html", "HTML", 0, 83, 0, 0, 2, 2, 87
"c:\Users\Josh\repos\doughleap\frontend\src\app\shared\ui\filterModals\numeric-filter-modal\numeric-filter-modal.component.ts", "TypeScript", 112, 0, 0, 0, 0, 10, 122
"c:\Users\Josh\repos\doughleap\frontend\src\app\shared\ui\filterModals\string-filter-modal\string-filter-modal.component.html", "HTML", 0, 63, 0, 0, 2, 2, 67
"c:\Users\Josh\repos\doughleap\frontend\src\app\shared\ui\filterModals\string-filter-modal\string-filter-modal.component.ts", "TypeScript", 80, 0, 0, 0, 2, 8, 90
"c:\Users\Josh\repos\doughleap\frontend\src\app\shared\ui\update-request-confirmation\update-request-confirmation-modal.component.html", "HTML", 0, 22, 0, 0, 0, 0, 22
"c:\Users\Josh\repos\doughleap\frontend\src\app\shared\ui\update-request-confirmation\update-request-confirmation-modal.component.ts", "TypeScript", 20, 0, 0, 0, 0, 8, 28
"c:\Users\Josh\repos\doughleap\frontend\src\app\shared\ui\update-request-error\update-request-error-modal.component.html", "HTML", 0, 22, 0, 0, 5, 0, 27
"c:\Users\Josh\repos\doughleap\frontend\src\app\shared\ui\update-request-error\update-request-error-modal.component.ts", "TypeScript", 20, 0, 0, 0, 0, 5, 25
"c:\Users\Josh\repos\doughleap\frontend\src\app\shared\utils\ID.ts", "TypeScript", 50, 0, 0, 0, 1, 2, 53
"c:\Users\Josh\repos\doughleap\frontend\src\app\shared\utils\authInterceptor.ts", "TypeScript", 33, 0, 0, 0, 0, 5, 38
"c:\Users\Josh\repos\doughleap\frontend\src\app\shared\utils\authenticationService.ts", "TypeScript", 302, 0, 0, 0, 31, 31, 364
"c:\Users\Josh\repos\doughleap\frontend\src\app\shared\utils\filterService.ts", "TypeScript", 121, 0, 0, 0, 7, 7, 135
"c:\Users\Josh\repos\doughleap\frontend\src\app\shared\utils\formValidator.ts", "TypeScript", 50, 0, 0, 0, 0, 10, 60
"c:\Users\Josh\repos\doughleap\frontend\src\app\shared\utils\photoService.ts", "TypeScript", 42, 0, 0, 0, 0, 7, 49
"c:\Users\Josh\repos\doughleap\frontend\src\app\shared\utils\sortingService.ts", "TypeScript", 40, 0, 0, 0, 4, 7, 51
"c:\Users\Josh\repos\doughleap\frontend\src\app\shared\utils\supabase.service.ts", "TypeScript", 26, 0, 0, 0, 1, 3, 30
"c:\Users\Josh\repos\doughleap\frontend\src\app\shared\utils\types.ts", "TypeScript", 79, 0, 0, 0, 3, 3, 85
"c:\Users\Josh\repos\doughleap\frontend\src\app\social\data\social.service.ts", "TypeScript", 102, 0, 0, 0, 11, 16, 129
"c:\Users\Josh\repos\doughleap\frontend\src\app\social\feature\followers\followers.component.html", "HTML", 0, 67, 0, 0, 3, 3, 73
"c:\Users\Josh\repos\doughleap\frontend\src\app\social\feature\followers\followers.component.ts", "TypeScript", 60, 0, 0, 0, 0, 9, 69
"c:\Users\Josh\repos\doughleap\frontend\src\app\social\feature\friends\friends.component.html", "HTML", 0, 69, 0, 0, 5, 3, 77
"c:\Users\Josh\repos\doughleap\frontend\src\app\social\feature\friends\friends.component.ts", "TypeScript", 89, 0, 0, 0, 1, 12, 102
"c:\Users\Josh\repos\doughleap\frontend\src\app\social\feature\friends\ui\add-friend-modal\add-friend-modal.component.html", "HTML", 0, 93, 0, 0, 3, 2, 98
"c:\Users\Josh\repos\doughleap\frontend\src\app\social\feature\friends\ui\add-friend-modal\add-friend-modal.component.ts", "TypeScript", 147, 0, 0, 0, 1, 14, 162
"c:\Users\Josh\repos\doughleap\frontend\src\app\social\feature\friends\ui\friend-card\friend-card.component.html", "HTML", 0, 26, 0, 0, 4, 3, 33
"c:\Users\Josh\repos\doughleap\frontend\src\app\social\feature\friends\ui\friend-card\friend-card.component.ts", "TypeScript", 17, 0, 0, 0, 0, 3, 20
"c:\Users\Josh\repos\doughleap\frontend\src\app\social\feature\friends\ui\friend-modal\friend-modal.component.html", "HTML", 0, 192, 0, 0, 13, 9, 214
"c:\Users\Josh\repos\doughleap\frontend\src\app\social\feature\friends\ui\friend-modal\friend-modal.component.ts", "TypeScript", 145, 0, 0, 0, 0, 11, 156
"c:\Users\Josh\repos\doughleap\frontend\src\app\social\feature\friends\ui\friend-requests-modal\friend-requests-modal.component.html", "HTML", 0, 16, 0, 0, 0, 1, 17
"c:\Users\Josh\repos\doughleap\frontend\src\app\social\feature\friends\ui\friend-requests-modal\friend-requests-modal.component.ts", "TypeScript", 37, 0, 0, 0, 1, 6, 44
"c:\Users\Josh\repos\doughleap\frontend\src\app\social\feature\friends\ui\profile-card\profile-card.component.html", "HTML", 0, 119, 0, 0, 10, 4, 133
"c:\Users\Josh\repos\doughleap\frontend\src\app\social\feature\friends\ui\profile-card\profile-card.component.ts", "TypeScript", 59, 0, 0, 0, 0, 6, 65
"c:\Users\Josh\repos\doughleap\frontend\src\app\social\feature\friends\ui\request-card\request-card.component.html", "HTML", 0, 45, 0, 0, 5, 3, 53
"c:\Users\Josh\repos\doughleap\frontend\src\app\social\feature\friends\ui\request-card\request-card.component.ts", "TypeScript", 43, 0, 0, 0, 1, 7, 51
"c:\Users\Josh\repos\doughleap\frontend\src\app\social\feature\timeline\state\timeline-state.ts", "TypeScript", 5, 0, 0, 0, 0, 1, 6
"c:\Users\Josh\repos\doughleap\frontend\src\app\social\feature\timeline\timeline.component.html", "HTML", 0, 1, 0, 0, 0, 1, 2
"c:\Users\Josh\repos\doughleap\frontend\src\app\social\feature\timeline\timeline.component.ts", "TypeScript", 10, 0, 0, 0, 0, 3, 13
"c:\Users\Josh\repos\doughleap\frontend\src\app\social\feature\timeline\ui\event\event.component.html", "HTML", 0, 1, 0, 0, 0, 1, 2
"c:\Users\Josh\repos\doughleap\frontend\src\app\social\feature\timeline\ui\event\event.component.ts", "TypeScript", 10, 0, 0, 0, 0, 3, 13
"c:\Users\Josh\repos\doughleap\frontend\src\app\social\social-page.component.html", "HTML", 0, 42, 0, 0, 2, 2, 46
"c:\Users\Josh\repos\doughleap\frontend\src\app\social\social-page.component.ts", "TypeScript", 32, 0, 0, 0, 0, 5, 37
"c:\Users\Josh\repos\doughleap\frontend\src\app\social\state\followship-actions.ts", "TypeScript", 73, 0, 0, 0, 0, 6, 79
"c:\Users\Josh\repos\doughleap\frontend\src\app\social\state\followship-effects.ts", "TypeScript", 108, 0, 0, 0, 0, 8, 116
"c:\Users\Josh\repos\doughleap\frontend\src\app\social\state\followship-reducers.ts", "TypeScript", 98, 0, 0, 0, 0, 2, 100
"c:\Users\Josh\repos\doughleap\frontend\src\app\social\state\followship-selectors.ts", "TypeScript", 21, 0, 0, 0, 0, 11, 32
"c:\Users\Josh\repos\doughleap\frontend\src\app\social\state\followship-state.ts", "TypeScript", 20, 0, 0, 0, 0, 2, 22
"c:\Users\Josh\repos\doughleap\frontend\src\app\social\state\friendship-actions.ts", "TypeScript", 76, 0, 0, 0, 0, 7, 83
"c:\Users\Josh\repos\doughleap\frontend\src\app\social\state\friendship-effects.ts", "TypeScript", 112, 0, 0, 0, 0, 8, 120
"c:\Users\Josh\repos\doughleap\frontend\src\app\social\state\friendship-reducers.ts", "TypeScript", 102, 0, 0, 0, 0, 2, 104
"c:\Users\Josh\repos\doughleap\frontend\src\app\social\state\friendship-selectors.ts", "TypeScript", 20, 0, 0, 0, 0, 9, 29
"c:\Users\Josh\repos\doughleap\frontend\src\app\social\state\friendship-state.ts", "TypeScript", 21, 0, 0, 0, 0, 2, 23
"Total", "-", 15845, 7409, 59, 8, 648, 1806, 25775