"filename", "language", "TypeScript", "HTML", "Draw.io", "comment", "blank", "total"
"/home/josh/repos/doughleap/frontend/src/app/account/feature/login/login-page.component.html", "HTML", 0, 99, 0, 7, 8, 114
"/home/josh/repos/doughleap/frontend/src/app/account/feature/login/login-page.component.spec.ts", "TypeScript", 17, 0, 0, 0, 5, 22
"/home/josh/repos/doughleap/frontend/src/app/account/feature/login/login-page.component.ts", "TypeScript", 152, 0, 0, 11, 16, 179
"/home/josh/repos/doughleap/frontend/src/app/account/feature/password/password-reset-page.component.html", "HTML", 0, 1, 0, 0, 1, 2
"/home/josh/repos/doughleap/frontend/src/app/account/feature/password/password-reset-page.component.ts", "TypeScript", 10, 0, 0, 0, 3, 13
"/home/josh/repos/doughleap/frontend/src/app/account/feature/signup/signup-page.component.html", "HTML", 0, 102, 0, 55, 8, 165
"/home/josh/repos/doughleap/frontend/src/app/account/feature/signup/signup-page.component.ts", "TypeScript", 89, 0, 0, 0, 9, 98
"/home/josh/repos/doughleap/frontend/src/app/account/feature/verify/verify.component.html", "HTML", 0, 1, 0, 0, 1, 2
"/home/josh/repos/doughleap/frontend/src/app/account/feature/verify/verify.component.ts", "TypeScript", 10, 0, 0, 0, 3, 13
"/home/josh/repos/doughleap/frontend/src/app/app.component.html", "HTML", 0, 6, 0, 0, 1, 7
"/home/josh/repos/doughleap/frontend/src/app/app.component.spec.ts", "TypeScript", 25, 0, 0, 0, 5, 30
"/home/josh/repos/doughleap/frontend/src/app/app.component.ts", "TypeScript", 132, 0, 0, 29, 11, 172
"/home/josh/repos/doughleap/frontend/src/app/footer/feature/app-footer.component.html", "HTML", 0, 253, 0, 3, 1, 257
"/home/josh/repos/doughleap/frontend/src/app/footer/feature/app-footer.component.ts", "TypeScript", 140, 0, 0, 1, 15, 156
"/home/josh/repos/doughleap/frontend/src/app/groceries/data/shopping-list-ingredient.service.ts", "TypeScript", 92, 0, 0, 0, 10, 102
"/home/josh/repos/doughleap/frontend/src/app/groceries/data/shopping-list-recipe.service.ts", "TypeScript", 38, 0, 0, 0, 8, 46
"/home/josh/repos/doughleap/frontend/src/app/groceries/data/shopping-list.service.ts", "TypeScript", 38, 0, 0, 0, 8, 46
"/home/josh/repos/doughleap/frontend/src/app/groceries/feature/draft-page/draft-page.component.html", "HTML", 0, 174, 0, 7, 4, 185
"/home/josh/repos/doughleap/frontend/src/app/groceries/feature/draft-page/draft-page.component.ts", "TypeScript", 588, 0, 0, 17, 24, 629
"/home/josh/repos/doughleap/frontend/src/app/groceries/feature/shopping-page/shopping-page.component.html", "HTML", 0, 182, 0, 12, 5, 199
"/home/josh/repos/doughleap/frontend/src/app/groceries/feature/shopping-page/shopping-page.component.ts", "TypeScript", 249, 0, 0, 5, 15, 269
"/home/josh/repos/doughleap/frontend/src/app/groceries/feature/shopping-page/ui/purchase-ingredients-modal/purchase-ingredients-modal.component.html", "HTML", 0, 72, 0, 2, 3, 77
"/home/josh/repos/doughleap/frontend/src/app/groceries/feature/shopping-page/ui/purchase-ingredients-modal/purchase-ingredients-modal.component.ts", "TypeScript", 50, 0, 0, 0, 7, 57
"/home/josh/repos/doughleap/frontend/src/app/groceries/groceries-page/groceries-page.component.html", "HTML", 0, 5, 0, 0, 1, 6
"/home/josh/repos/doughleap/frontend/src/app/groceries/groceries-page/groceries-page.component.ts", "TypeScript", 90, 0, 0, 0, 8, 98
"/home/josh/repos/doughleap/frontend/src/app/groceries/state/shopping-list-actions.ts", "TypeScript", 77, 0, 0, 0, 7, 84
"/home/josh/repos/doughleap/frontend/src/app/groceries/state/shopping-list-effects.ts", "TypeScript", 154, 0, 0, 0, 11, 165
"/home/josh/repos/doughleap/frontend/src/app/groceries/state/shopping-list-ingredient-actions.ts", "TypeScript", 98, 0, 0, 0, 7, 105
"/home/josh/repos/doughleap/frontend/src/app/groceries/state/shopping-list-ingredient-effects.ts", "TypeScript", 354, 0, 0, 9, 14, 377
"/home/josh/repos/doughleap/frontend/src/app/groceries/state/shopping-list-ingredient-reducers.ts", "TypeScript", 111, 0, 0, 0, 3, 114
"/home/josh/repos/doughleap/frontend/src/app/groceries/state/shopping-list-ingredient-selectors.ts", "TypeScript", 7, 0, 0, 0, 1, 8
"/home/josh/repos/doughleap/frontend/src/app/groceries/state/shopping-list-ingredient-state.ts", "TypeScript", 31, 0, 0, 0, 2, 33
"/home/josh/repos/doughleap/frontend/src/app/groceries/state/shopping-list-recipe-actions.ts", "TypeScript", 55, 0, 0, 0, 6, 61
"/home/josh/repos/doughleap/frontend/src/app/groceries/state/shopping-list-recipe-effects.ts", "TypeScript", 145, 0, 0, 0, 8, 153
"/home/josh/repos/doughleap/frontend/src/app/groceries/state/shopping-list-recipe-reducers.ts", "TypeScript", 74, 0, 0, 0, 3, 77
"/home/josh/repos/doughleap/frontend/src/app/groceries/state/shopping-list-recipe-selectors.ts", "TypeScript", 6, 0, 0, 0, 1, 7
"/home/josh/repos/doughleap/frontend/src/app/groceries/state/shopping-list-recipe-state.ts", "TypeScript", 20, 0, 0, 0, 2, 22
"/home/josh/repos/doughleap/frontend/src/app/groceries/state/shopping-list-reducers.ts", "TypeScript", 109, 0, 0, 0, 4, 113
"/home/josh/repos/doughleap/frontend/src/app/groceries/state/shopping-list-selectors.ts", "TypeScript", 6, 0, 0, 0, 1, 7
"/home/josh/repos/doughleap/frontend/src/app/groceries/state/shopping-list-state.ts", "TypeScript", 36, 0, 0, 0, 4, 40
"/home/josh/repos/doughleap/frontend/src/app/groceries/ui/add-shopping-list-ingredient-modal/add-shopping-list-ingredient-modal.component.html", "HTML", 0, 115, 0, 5, 3, 123
"/home/josh/repos/doughleap/frontend/src/app/groceries/ui/add-shopping-list-ingredient-modal/add-shopping-list-ingredient-modal.component.ts", "TypeScript", 159, 0, 0, 2, 10, 171
"/home/josh/repos/doughleap/frontend/src/app/groceries/ui/add-shopping-list-recipe-modal/add-shopping-list-recipe-modal.component.html", "HTML", 0, 134, 0, 6, 5, 145
"/home/josh/repos/doughleap/frontend/src/app/groceries/ui/add-shopping-list-recipe-modal/add-shopping-list-recipe-modal.component.ts", "TypeScript", 317, 0, 0, 4, 13, 334
"/home/josh/repos/doughleap/frontend/src/app/guards/profile.guard.ts", "TypeScript", 30, 0, 0, 3, 3, 36
"/home/josh/repos/doughleap/frontend/src/app/home/home.component.html", "HTML", 0, 19, 0, 0, 1, 20
"/home/josh/repos/doughleap/frontend/src/app/home/home.component.ts", "TypeScript", 25, 0, 0, 7, 4, 36
"/home/josh/repos/doughleap/frontend/src/app/kitchen/feature/Inventory/feature/ingredient-inventory/data/ingredient-stock.service.ts", "TypeScript", 152, 0, 0, 7, 17, 176
"/home/josh/repos/doughleap/frontend/src/app/kitchen/feature/Inventory/feature/ingredient-inventory/state/ingredient-stock-actions.ts", "TypeScript", 91, 0, 0, 0, 5, 96
"/home/josh/repos/doughleap/frontend/src/app/kitchen/feature/Inventory/feature/ingredient-inventory/state/ingredient-stock-effects.ts", "TypeScript", 166, 0, 0, 1, 8, 175
"/home/josh/repos/doughleap/frontend/src/app/kitchen/feature/Inventory/feature/ingredient-inventory/state/ingredient-stock-reducers.ts", "TypeScript", 136, 0, 0, 0, 2, 138
"/home/josh/repos/doughleap/frontend/src/app/kitchen/feature/Inventory/feature/ingredient-inventory/state/ingredient-stock-selectors.ts", "TypeScript", 23, 0, 0, 0, 9, 32
"/home/josh/repos/doughleap/frontend/src/app/kitchen/feature/Inventory/feature/ingredient-inventory/state/ingredient-stock-state.ts", "TypeScript", 29, 0, 0, 0, 4, 33
"/home/josh/repos/doughleap/frontend/src/app/kitchen/feature/Inventory/feature/ingredient-inventory/ui/add-ingredient-stock-modal/add-ingredient-stock-modal.component.html", "HTML", 0, 88, 0, 2, 5, 95
"/home/josh/repos/doughleap/frontend/src/app/kitchen/feature/Inventory/feature/ingredient-inventory/ui/add-ingredient-stock-modal/add-ingredient-stock-modal.component.ts", "TypeScript", 154, 0, 0, 2, 14, 170
"/home/josh/repos/doughleap/frontend/src/app/kitchen/feature/Inventory/feature/ingredient-inventory/ui/delete-ingredient-stock-modal/delete-ingredient-stock-modal.component.html", "HTML", 0, 63, 0, 0, 1, 64
"/home/josh/repos/doughleap/frontend/src/app/kitchen/feature/Inventory/feature/ingredient-inventory/ui/delete-ingredient-stock-modal/delete-ingredient-stock-modal.component.ts", "TypeScript", 73, 0, 0, 1, 6, 80
"/home/josh/repos/doughleap/frontend/src/app/kitchen/feature/Inventory/feature/ingredient-inventory/ui/edit-ingredient-stock-modal/edit-ingredient-stock-modal.component.html", "HTML", 0, 75, 0, 2, 4, 81
"/home/josh/repos/doughleap/frontend/src/app/kitchen/feature/Inventory/feature/ingredient-inventory/ui/edit-ingredient-stock-modal/edit-ingredient-stock-modal.component.ts", "TypeScript", 197, 0, 0, 2, 15, 214
"/home/josh/repos/doughleap/frontend/src/app/kitchen/feature/Inventory/feature/tool-inventory/data/tool-stock.service.ts", "TypeScript", 72, 0, 0, 1, 10, 83
"/home/josh/repos/doughleap/frontend/src/app/kitchen/feature/Inventory/feature/tool-inventory/state/tool-stock-actions.ts", "TypeScript", 76, 0, 0, 0, 5, 81
"/home/josh/repos/doughleap/frontend/src/app/kitchen/feature/Inventory/feature/tool-inventory/state/tool-stock-effects.ts", "TypeScript", 139, 0, 0, 0, 7, 146
"/home/josh/repos/doughleap/frontend/src/app/kitchen/feature/Inventory/feature/tool-inventory/state/tool-stock-reducers.ts", "TypeScript", 125, 0, 0, 0, 3, 128
"/home/josh/repos/doughleap/frontend/src/app/kitchen/feature/Inventory/feature/tool-inventory/state/tool-stock-selectors.ts", "TypeScript", 28, 0, 0, 0, 9, 37
"/home/josh/repos/doughleap/frontend/src/app/kitchen/feature/Inventory/feature/tool-inventory/state/tool-stock-state.ts", "TypeScript", 27, 0, 0, 0, 3, 30
"/home/josh/repos/doughleap/frontend/src/app/kitchen/feature/Inventory/feature/tool-inventory/ui/add-tool-stock-modal/add-tool-stock-modal.component.html", "HTML", 0, 59, 0, 2, 4, 65
"/home/josh/repos/doughleap/frontend/src/app/kitchen/feature/Inventory/feature/tool-inventory/ui/add-tool-stock-modal/add-tool-stock-modal.component.ts", "TypeScript", 144, 0, 0, 1, 13, 158
"/home/josh/repos/doughleap/frontend/src/app/kitchen/feature/Inventory/feature/tool-inventory/ui/delete-tool-stock-modal/delete-tool-stock-modal.component.html", "HTML", 0, 63, 0, 0, 1, 64
"/home/josh/repos/doughleap/frontend/src/app/kitchen/feature/Inventory/feature/tool-inventory/ui/delete-tool-stock-modal/delete-tool-stock-modal.component.ts", "TypeScript", 70, 0, 0, 1, 6, 77
"/home/josh/repos/doughleap/frontend/src/app/kitchen/feature/Inventory/feature/tool-inventory/ui/edit-tool-stock-modal/edit-tool-stock-modal.component.html", "HTML", 0, 87, 0, 2, 3, 92
"/home/josh/repos/doughleap/frontend/src/app/kitchen/feature/Inventory/feature/tool-inventory/ui/edit-tool-stock-modal/edit-tool-stock-modal.component.ts", "TypeScript", 160, 0, 0, 0, 15, 175
"/home/josh/repos/doughleap/frontend/src/app/kitchen/feature/ingredients/data/ingredient.service.ts", "TypeScript", 100, 0, 0, 1, 15, 116
"/home/josh/repos/doughleap/frontend/src/app/kitchen/feature/ingredients/ingredients.component.html", "HTML", 0, 118, 0, 7, 5, 130
"/home/josh/repos/doughleap/frontend/src/app/kitchen/feature/ingredients/ingredients.component.ts", "TypeScript", 260, 0, 0, 4, 22, 286
"/home/josh/repos/doughleap/frontend/src/app/kitchen/feature/ingredients/state/ingredient-actions.ts", "TypeScript", 76, 0, 0, 0, 5, 81
"/home/josh/repos/doughleap/frontend/src/app/kitchen/feature/ingredients/state/ingredient-effects.ts", "TypeScript", 151, 0, 0, 0, 10, 161
"/home/josh/repos/doughleap/frontend/src/app/kitchen/feature/ingredients/state/ingredient-reducers.ts", "TypeScript", 101, 0, 0, 0, 3, 104
"/home/josh/repos/doughleap/frontend/src/app/kitchen/feature/ingredients/state/ingredient-selectors.ts", "TypeScript", 17, 0, 0, 0, 8, 25
"/home/josh/repos/doughleap/frontend/src/app/kitchen/feature/ingredients/state/ingredient-state.ts", "TypeScript", 24, 0, 0, 0, 3, 27
"/home/josh/repos/doughleap/frontend/src/app/kitchen/feature/ingredients/ui/add-ingredient-modal/add-ingredient-modal.component.html", "HTML", 0, 102, 0, 2, 7, 111
"/home/josh/repos/doughleap/frontend/src/app/kitchen/feature/ingredients/ui/add-ingredient-modal/add-ingredient-modal.component.ts", "TypeScript", 219, 0, 0, 5, 15, 239
"/home/josh/repos/doughleap/frontend/src/app/kitchen/feature/ingredients/ui/delete-ingredient-modal/delete-ingredient-modal.component.html", "HTML", 0, 66, 0, 0, 1, 67
"/home/josh/repos/doughleap/frontend/src/app/kitchen/feature/ingredients/ui/delete-ingredient-modal/delete-ingredient-modal.component.ts", "TypeScript", 70, 0, 0, 1, 6, 77
"/home/josh/repos/doughleap/frontend/src/app/kitchen/feature/ingredients/ui/edit-ingredient-modal/edit-ingredient-modal.component.html", "HTML", 0, 145, 0, 3, 7, 155
"/home/josh/repos/doughleap/frontend/src/app/kitchen/feature/ingredients/ui/edit-ingredient-modal/edit-ingredient-modal.component.ts", "TypeScript", 244, 0, 0, 3, 19, 266
"/home/josh/repos/doughleap/frontend/src/app/kitchen/feature/ingredients/ui/ingredient-details-modal/ingredient-details-modal.component.html", "HTML", 0, 165, 0, 8, 4, 177
"/home/josh/repos/doughleap/frontend/src/app/kitchen/feature/ingredients/ui/ingredient-details-modal/ingredient-details-modal.component.ts", "TypeScript", 244, 0, 0, 3, 19, 266
"/home/josh/repos/doughleap/frontend/src/app/kitchen/feature/tools/data/tool.service.ts", "TypeScript", 81, 0, 0, 0, 13, 94
"/home/josh/repos/doughleap/frontend/src/app/kitchen/feature/tools/state/tool-actions.ts", "TypeScript", 76, 0, 0, 0, 7, 83
"/home/josh/repos/doughleap/frontend/src/app/kitchen/feature/tools/state/tool-effects.ts", "TypeScript", 116, 0, 0, 0, 6, 122
"/home/josh/repos/doughleap/frontend/src/app/kitchen/feature/tools/state/tool-reducers.ts", "TypeScript", 98, 0, 0, 0, 2, 100
"/home/josh/repos/doughleap/frontend/src/app/kitchen/feature/tools/state/tool-selectors.ts", "TypeScript", 13, 0, 0, 0, 8, 21
"/home/josh/repos/doughleap/frontend/src/app/kitchen/feature/tools/state/tool-state.ts", "TypeScript", 20, 0, 0, 0, 2, 22
"/home/josh/repos/doughleap/frontend/src/app/kitchen/feature/tools/tools.component.html", "HTML", 0, 80, 0, 6, 4, 90
"/home/josh/repos/doughleap/frontend/src/app/kitchen/feature/tools/tools.component.ts", "TypeScript", 164, 0, 0, 2, 21, 187
"/home/josh/repos/doughleap/frontend/src/app/kitchen/feature/tools/ui/add-tool-modal/add-tool-modal.component.html", "HTML", 0, 55, 0, 2, 4, 61
"/home/josh/repos/doughleap/frontend/src/app/kitchen/feature/tools/ui/add-tool-modal/add-tool-modal.component.ts", "TypeScript", 104, 0, 0, 0, 9, 113
"/home/josh/repos/doughleap/frontend/src/app/kitchen/feature/tools/ui/delete-tool-modal/delete-tool-modal.component.html", "HTML", 0, 68, 0, 0, 1, 69
"/home/josh/repos/doughleap/frontend/src/app/kitchen/feature/tools/ui/delete-tool-modal/delete-tool-modal.component.ts", "TypeScript", 73, 0, 0, 1, 6, 80
"/home/josh/repos/doughleap/frontend/src/app/kitchen/feature/tools/ui/edit-tool-modal/edit-tool-modal.component.html", "HTML", 0, 54, 0, 2, 2, 58
"/home/josh/repos/doughleap/frontend/src/app/kitchen/feature/tools/ui/edit-tool-modal/edit-tool-modal.component.ts", "TypeScript", 136, 0, 0, 0, 11, 147
"/home/josh/repos/doughleap/frontend/src/app/kitchen/feature/tools/ui/tool-details-modal/tool-details-modal.component.html", "HTML", 0, 148, 0, 8, 3, 159
"/home/josh/repos/doughleap/frontend/src/app/kitchen/feature/tools/ui/tool-details-modal/tool-details-modal.component.ts", "TypeScript", 233, 0, 0, 3, 18, 254
"/home/josh/repos/doughleap/frontend/src/app/kitchen/kitchen-page.component.html", "HTML", 0, 27, 0, 2, 1, 30
"/home/josh/repos/doughleap/frontend/src/app/kitchen/kitchen-page.component.ts", "TypeScript", 65, 0, 0, 0, 6, 71
"/home/josh/repos/doughleap/frontend/src/app/kitchen/state/kitchen-actions.ts", "TypeScript", 26, 0, 0, 0, 6, 32
"/home/josh/repos/doughleap/frontend/src/app/kitchen/state/kitchen-interfaces.ts", "TypeScript", 16, 0, 0, 0, 2, 18
"/home/josh/repos/doughleap/frontend/src/app/kitchen/state/kitchen-reducers.ts", "TypeScript", 26, 0, 0, 1, 4, 31
"/home/josh/repos/doughleap/frontend/src/app/kitchen/state/kitchen-selectors.ts", "TypeScript", 8, 0, 0, 0, 2, 10
"/home/josh/repos/doughleap/frontend/src/app/kitchen/state/kitchen-state.ts", "TypeScript", 5, 0, 0, 0, 0, 5
"/home/josh/repos/doughleap/frontend/src/app/profile/data/profile.service.ts", "TypeScript", 58, 0, 0, 0, 13, 71
"/home/josh/repos/doughleap/frontend/src/app/profile/profile.component.html", "HTML", 0, 202, 0, 14, 9, 225
"/home/josh/repos/doughleap/frontend/src/app/profile/profile.component.ts", "TypeScript", 95, 0, 0, 1, 12, 108
"/home/josh/repos/doughleap/frontend/src/app/profile/state/profile-actions.ts", "TypeScript", 151, 0, 0, 0, 14, 165
"/home/josh/repos/doughleap/frontend/src/app/profile/state/profile-effects.ts", "TypeScript", 248, 0, 0, 1, 14, 263
"/home/josh/repos/doughleap/frontend/src/app/profile/state/profile-reducers.ts", "TypeScript", 213, 0, 0, 0, 2, 215
"/home/josh/repos/doughleap/frontend/src/app/profile/state/profile-selectors.ts", "TypeScript", 24, 0, 0, 0, 16, 40
"/home/josh/repos/doughleap/frontend/src/app/profile/state/profile-state.ts", "TypeScript", 47, 0, 0, 1, 5, 53
"/home/josh/repos/doughleap/frontend/src/app/profile/ui/edit-photo-modal/edit-photo-modal.component.html", "HTML", 0, 69, 0, 2, 4, 75
"/home/josh/repos/doughleap/frontend/src/app/profile/ui/edit-photo-modal/edit-photo-modal.component.ts", "TypeScript", 149, 0, 0, 8, 13, 170
"/home/josh/repos/doughleap/frontend/src/app/profile/ui/edit-profile-modal/edit-profile-modal.component.html", "HTML", 0, 81, 0, 2, 3, 86
"/home/josh/repos/doughleap/frontend/src/app/profile/ui/edit-profile-modal/edit-profile-modal.component.ts", "TypeScript", 104, 0, 0, 0, 8, 112
"/home/josh/repos/doughleap/frontend/src/app/recipes/data/recipe-category.service.ts", "TypeScript", 35, 0, 0, 0, 6, 41
"/home/josh/repos/doughleap/frontend/src/app/recipes/data/recipe-ingredients.service.ts", "TypeScript", 83, 0, 0, 1, 11, 95
"/home/josh/repos/doughleap/frontend/src/app/recipes/data/recipe-step.service.ts", "TypeScript", 61, 0, 0, 0, 10, 71
"/home/josh/repos/doughleap/frontend/src/app/recipes/data/recipe-tool.service.ts", "TypeScript", 61, 0, 0, 0, 10, 71
"/home/josh/repos/doughleap/frontend/src/app/recipes/data/recipe.service.ts", "TypeScript", 325, 0, 0, 7, 28, 360
"/home/josh/repos/doughleap/frontend/src/app/recipes/data/recipeVisionProgress.service.ts", "TypeScript", 36, 0, 0, 0, 6, 42
"/home/josh/repos/doughleap/frontend/src/app/recipes/data/step.service.ts", "TypeScript", 50, 0, 0, 0, 9, 59
"/home/josh/repos/doughleap/frontend/src/app/recipes/feature/created-recipes/created-recipes.component.html", "HTML", 0, 4, 0, 0, 1, 5
"/home/josh/repos/doughleap/frontend/src/app/recipes/feature/created-recipes/created-recipes.component.ts", "TypeScript", 9, 0, 0, 0, 3, 12
"/home/josh/repos/doughleap/frontend/src/app/recipes/feature/discover/discover-recipes.component.html", "HTML", 0, 138, 0, 8, 5, 151
"/home/josh/repos/doughleap/frontend/src/app/recipes/feature/discover/discover-recipes.component.ts", "TypeScript", 113, 0, 0, 6, 10, 129
"/home/josh/repos/doughleap/frontend/src/app/recipes/feature/recipe/public-recipe/public-recipe.component.html", "HTML", 0, 283, 0, 17, 9, 309
"/home/josh/repos/doughleap/frontend/src/app/recipes/feature/recipe/public-recipe/public-recipe.component.ts", "TypeScript", 302, 0, 0, 10, 18, 330
"/home/josh/repos/doughleap/frontend/src/app/recipes/feature/recipe/ui/delete-recipe-modal/delete-recipe-modal.component.html", "HTML", 0, 60, 0, 0, 1, 61
"/home/josh/repos/doughleap/frontend/src/app/recipes/feature/recipe/ui/delete-recipe-modal/delete-recipe-modal.component.ts", "TypeScript", 82, 0, 0, 1, 8, 91
"/home/josh/repos/doughleap/frontend/src/app/recipes/feature/recipe/ui/edit-recipe-modal/edit-recipe-modal.component.html", "HTML", 0, 227, 0, 5, 5, 237
"/home/josh/repos/doughleap/frontend/src/app/recipes/feature/recipe/ui/edit-recipe-modal/edit-recipe-modal.component.ts", "TypeScript", 343, 0, 0, 8, 20, 371
"/home/josh/repos/doughleap/frontend/src/app/recipes/feature/recipe/ui/recipe-shopping-list-modal/recipe-shopping-list-modal.component.html", "HTML", 0, 102, 0, 8, 8, 118
"/home/josh/repos/doughleap/frontend/src/app/recipes/feature/recipe/ui/recipe-shopping-list-modal/recipe-shopping-list-modal.component.ts", "TypeScript", 157, 0, 0, 1, 10, 168
"/home/josh/repos/doughleap/frontend/src/app/recipes/feature/recipe/ui/subscribe-recipe-modal/subscribe-recipe-modal.component.html", "HTML", 0, 181, 0, 12, 8, 201
"/home/josh/repos/doughleap/frontend/src/app/recipes/feature/recipe/ui/subscribe-recipe-modal/subscribe-recipe-modal.component.ts", "TypeScript", 390, 0, 0, 18, 31, 439
"/home/josh/repos/doughleap/frontend/src/app/recipes/feature/recipe/ui/unsubscribe-recipe-modal/unsubscribe-recipe-modal.component.html", "HTML", 0, 48, 0, 0, 1, 49
"/home/josh/repos/doughleap/frontend/src/app/recipes/feature/recipe/ui/unsubscribe-recipe-modal/unsubscribe-recipe-modal.component.ts", "TypeScript", 83, 0, 0, 0, 7, 90
"/home/josh/repos/doughleap/frontend/src/app/recipes/feature/recipe/ui/use-recipe-modal/use-recipe-modal.component.html", "HTML", 0, 143, 0, 5, 6, 154
"/home/josh/repos/doughleap/frontend/src/app/recipes/feature/recipe/ui/use-recipe-modal/use-recipe-modal.component.ts", "TypeScript", 123, 0, 0, 0, 10, 133
"/home/josh/repos/doughleap/frontend/src/app/recipes/feature/recipe/ui/using-recipe/using-recipe.component.html", "HTML", 0, 185, 0, 14, 7, 206
"/home/josh/repos/doughleap/frontend/src/app/recipes/feature/recipe/ui/using-recipe/using-recipe.component.ts", "TypeScript", 228, 0, 0, 11, 19, 258
"/home/josh/repos/doughleap/frontend/src/app/recipes/feature/recipe/user-recipe/user-recipe.component.html", "HTML", 0, 694, 0, 24, 11, 729
"/home/josh/repos/doughleap/frontend/src/app/recipes/feature/recipe/user-recipe/user-recipe.component.ts", "TypeScript", 650, 0, 0, 55, 27, 732
"/home/josh/repos/doughleap/frontend/src/app/recipes/feature/recipes-page/feature/list/recipe-list.component.html", "HTML", 0, 105, 0, 5, 3, 113
"/home/josh/repos/doughleap/frontend/src/app/recipes/feature/recipes-page/feature/list/recipe-list.component.ts", "TypeScript", 292, 0, 0, 10, 18, 320
"/home/josh/repos/doughleap/frontend/src/app/recipes/feature/recipes-page/recipes-page.component-new.html", "HTML", 0, 40, 0, 2, 2, 44
"/home/josh/repos/doughleap/frontend/src/app/recipes/feature/recipes-page/recipes-page.component-new.ts", "TypeScript", 103, 0, 0, 4, 15, 122
"/home/josh/repos/doughleap/frontend/src/app/recipes/feature/recipes-page/test.drawio", "Draw.io", 0, 0, 59, 0, 0, 59
"/home/josh/repos/doughleap/frontend/src/app/recipes/feature/recipes-page/ui/recipe-category/recipe-category-card/recipe-category-card.component.html", "HTML", 0, 39, 0, 0, 1, 40
"/home/josh/repos/doughleap/frontend/src/app/recipes/feature/recipes-page/ui/recipe-category/recipe-category-card/recipe-category-card.component.ts", "TypeScript", 19, 0, 0, 0, 4, 23
"/home/josh/repos/doughleap/frontend/src/app/recipes/feature/recipes-page/ui/recipe-ingredient/add-recipe-ingredient-modal/add-recipe-ingredient-modal.component.html", "HTML", 0, 182, 0, 5, 2, 189
"/home/josh/repos/doughleap/frontend/src/app/recipes/feature/recipes-page/ui/recipe-ingredient/add-recipe-ingredient-modal/add-recipe-ingredient-modal.component.ts", "TypeScript", 257, 0, 0, 7, 22, 286
"/home/josh/repos/doughleap/frontend/src/app/recipes/feature/recipes-page/ui/recipe-ingredient/delete-recipe-ingredient-modal/delete-recipe-ingredient-modal.component.html", "HTML", 0, 49, 0, 0, 1, 50
"/home/josh/repos/doughleap/frontend/src/app/recipes/feature/recipes-page/ui/recipe-ingredient/delete-recipe-ingredient-modal/delete-recipe-ingredient-modal.component.ts", "TypeScript", 74, 0, 0, 1, 7, 82
"/home/josh/repos/doughleap/frontend/src/app/recipes/feature/recipes-page/ui/recipe-ingredient/edit-recipe-ingredient-modal/edit-recipe-ingredient-modal.component.html", "HTML", 0, 180, 0, 5, 5, 190
"/home/josh/repos/doughleap/frontend/src/app/recipes/feature/recipes-page/ui/recipe-ingredient/edit-recipe-ingredient-modal/edit-recipe-ingredient-modal.component.ts", "TypeScript", 235, 0, 0, 3, 14, 252
"/home/josh/repos/doughleap/frontend/src/app/recipes/feature/recipes-page/ui/recipe-ingredient/recipe-ingredients-modal/recipe-ingredients-modal.component.html", "HTML", 0, 166, 0, 4, 3, 173
"/home/josh/repos/doughleap/frontend/src/app/recipes/feature/recipes-page/ui/recipe-ingredient/recipe-ingredients-modal/recipe-ingredients-modal.component.ts", "TypeScript", 299, 0, 0, 14, 21, 334
"/home/josh/repos/doughleap/frontend/src/app/recipes/feature/recipes-page/ui/recipe-step/add-recipe-step-modal/add-recipe-step-modal.component.html", "HTML", 0, 105, 0, 2, 3, 110
"/home/josh/repos/doughleap/frontend/src/app/recipes/feature/recipes-page/ui/recipe-step/add-recipe-step-modal/add-recipe-step-modal.component.ts", "TypeScript", 161, 0, 0, 2, 20, 183
"/home/josh/repos/doughleap/frontend/src/app/recipes/feature/recipes-page/ui/recipe-step/delete-recipe-step-modal/delete-recipe-step-modal.component.html", "HTML", 0, 67, 0, 0, 1, 68
"/home/josh/repos/doughleap/frontend/src/app/recipes/feature/recipes-page/ui/recipe-step/delete-recipe-step-modal/delete-recipe-step-modal.component.ts", "TypeScript", 63, 0, 0, 1, 8, 72
"/home/josh/repos/doughleap/frontend/src/app/recipes/feature/recipes-page/ui/recipe-step/edit-recipe-step-modal/edit-recipe-step-modal.component.html", "HTML", 0, 111, 0, 2, 3, 116
"/home/josh/repos/doughleap/frontend/src/app/recipes/feature/recipes-page/ui/recipe-step/edit-recipe-step-modal/edit-recipe-step-modal.component.ts", "TypeScript", 193, 0, 0, 12, 17, 222
"/home/josh/repos/doughleap/frontend/src/app/recipes/feature/recipes-page/ui/recipe-step/recipe-steps-modal/recipe-steps-modal.component.html", "HTML", 0, 145, 0, 2, 3, 150
"/home/josh/repos/doughleap/frontend/src/app/recipes/feature/recipes-page/ui/recipe-step/recipe-steps-modal/recipe-steps-modal.component.ts", "TypeScript", 524, 0, 0, 25, 52, 601
"/home/josh/repos/doughleap/frontend/src/app/recipes/feature/recipes-page/ui/recipe-tool/add-recipe-tool-modal/add-recipe-tool-modal.component.html", "HTML", 0, 84, 0, 2, 2, 88
"/home/josh/repos/doughleap/frontend/src/app/recipes/feature/recipes-page/ui/recipe-tool/add-recipe-tool-modal/add-recipe-tool-modal.component.ts", "TypeScript", 108, 0, 0, 0, 10, 118
"/home/josh/repos/doughleap/frontend/src/app/recipes/feature/recipes-page/ui/recipe-tool/delete-recipe-tool-modal/delete-recipe-tool-modal.component.html", "HTML", 0, 65, 0, 0, 1, 66
"/home/josh/repos/doughleap/frontend/src/app/recipes/feature/recipes-page/ui/recipe-tool/delete-recipe-tool-modal/delete-recipe-tool-modal.component.ts", "TypeScript", 75, 0, 0, 1, 7, 83
"/home/josh/repos/doughleap/frontend/src/app/recipes/feature/recipes-page/ui/recipe-tool/recipe-tools-modal/recipe-tools-modal.component.html", "HTML", 0, 108, 0, 2, 3, 113
"/home/josh/repos/doughleap/frontend/src/app/recipes/feature/recipes-page/ui/recipe-tool/recipe-tools-modal/recipe-tools-modal.component.ts", "TypeScript", 252, 0, 0, 5, 18, 275
"/home/josh/repos/doughleap/frontend/src/app/recipes/feature/recipes-page/ui/recipe/add-recipe-modal/add-recipe-modal.component.html", "HTML", 0, 44, 0, 6, 6, 56
"/home/josh/repos/doughleap/frontend/src/app/recipes/feature/recipes-page/ui/recipe/add-recipe-modal/add-recipe-modal.component.ts", "TypeScript", 93, 0, 0, 7, 13, 113
"/home/josh/repos/doughleap/frontend/src/app/recipes/feature/recipes-page/ui/recipe/from-url-add-recipe-modal/from-url-add-recipe-modal.component.html", "HTML", 0, 96, 0, 5, 5, 106
"/home/josh/repos/doughleap/frontend/src/app/recipes/feature/recipes-page/ui/recipe/from-url-add-recipe-modal/from-url-add-recipe-modal.component.ts", "TypeScript", 197, 0, 0, 7, 17, 221
"/home/josh/repos/doughleap/frontend/src/app/recipes/feature/recipes-page/ui/recipe/manual-add-recipe-modal/manual-add-recipe-modal.component.html", "HTML", 0, 225, 0, 2, 4, 231
"/home/josh/repos/doughleap/frontend/src/app/recipes/feature/recipes-page/ui/recipe/manual-add-recipe-modal/manual-add-recipe-modal.component.ts", "TypeScript", 212, 0, 0, 2, 21, 235
"/home/josh/repos/doughleap/frontend/src/app/recipes/feature/recipes-page/ui/recipe/recipe-card/recipe-card.component.html", "HTML", 0, 68, 0, 0, 1, 69
"/home/josh/repos/doughleap/frontend/src/app/recipes/feature/recipes-page/ui/recipe/recipe-card/recipe-card.component.ts", "TypeScript", 66, 0, 0, 2, 4, 72
"/home/josh/repos/doughleap/frontend/src/app/recipes/feature/recipes-page/ui/recipe/vision-add-recipe-modal/vision-add-recipe-modal.component.html", "HTML", 0, 111, 0, 4, 4, 119
"/home/josh/repos/doughleap/frontend/src/app/recipes/feature/recipes-page/ui/recipe/vision-add-recipe-modal/vision-add-recipe-modal.component.ts", "TypeScript", 200, 0, 0, 11, 18, 229
"/home/josh/repos/doughleap/frontend/src/app/recipes/feature/recipes-page/ui/recipes-info/recipes-info.component.html", "HTML", 0, 4, 0, 0, 1, 5
"/home/josh/repos/doughleap/frontend/src/app/recipes/feature/recipes-page/ui/recipes-info/recipes-info.component.ts", "TypeScript", 10, 0, 0, 0, 3, 13
"/home/josh/repos/doughleap/frontend/src/app/recipes/feature/subscribed-recipes/subscribed-recipes.component.html", "HTML", 0, 4, 0, 0, 1, 5
"/home/josh/repos/doughleap/frontend/src/app/recipes/feature/subscribed-recipes/subscribed-recipes.component.ts", "TypeScript", 9, 0, 0, 0, 2, 11
"/home/josh/repos/doughleap/frontend/src/app/recipes/state/recipe-category/recipe-category-actions.ts", "TypeScript", 31, 0, 0, 0, 5, 36
"/home/josh/repos/doughleap/frontend/src/app/recipes/state/recipe-category/recipe-category-effects.ts", "TypeScript", 38, 0, 0, 0, 3, 41
"/home/josh/repos/doughleap/frontend/src/app/recipes/state/recipe-category/recipe-category-reducers.ts", "TypeScript", 56, 0, 0, 0, 3, 59
"/home/josh/repos/doughleap/frontend/src/app/recipes/state/recipe-category/recipe-category-selectors.ts", "TypeScript", 17, 0, 0, 0, 8, 25
"/home/josh/repos/doughleap/frontend/src/app/recipes/state/recipe-category/recipe-category-state.ts", "TypeScript", 22, 0, 0, 0, 3, 25
"/home/josh/repos/doughleap/frontend/src/app/recipes/state/recipe-ingredient/recipe-ingredient-actions.ts", "TypeScript", 76, 0, 0, 0, 7, 83
"/home/josh/repos/doughleap/frontend/src/app/recipes/state/recipe-ingredient/recipe-ingredient-effects.ts", "TypeScript", 191, 0, 0, 0, 8, 199
"/home/josh/repos/doughleap/frontend/src/app/recipes/state/recipe-ingredient/recipe-ingredient-reducers.ts", "TypeScript", 134, 0, 0, 0, 4, 138
"/home/josh/repos/doughleap/frontend/src/app/recipes/state/recipe-ingredient/recipe-ingredient-selectors.ts", "TypeScript", 30, 0, 0, 1, 10, 41
"/home/josh/repos/doughleap/frontend/src/app/recipes/state/recipe-ingredient/recipe-ingredient-state.ts", "TypeScript", 25, 0, 0, 0, 2, 27
"/home/josh/repos/doughleap/frontend/src/app/recipes/state/recipe-page-actions.ts", "TypeScript", 8, 0, 0, 0, 1, 9
"/home/josh/repos/doughleap/frontend/src/app/recipes/state/recipe-page-reducers.ts", "TypeScript", 10, 0, 0, 0, 2, 12
"/home/josh/repos/doughleap/frontend/src/app/recipes/state/recipe-page-selectors.ts", "TypeScript", 4, 0, 0, 0, 2, 6
"/home/josh/repos/doughleap/frontend/src/app/recipes/state/recipe-page-state.ts", "TypeScript", 3, 0, 0, 0, 0, 3
"/home/josh/repos/doughleap/frontend/src/app/recipes/state/recipe-step/recipe-step-actions.ts", "TypeScript", 36, 0, 0, 0, 8, 44
"/home/josh/repos/doughleap/frontend/src/app/recipes/state/recipe-step/recipe-step-effects.ts", "TypeScript", 196, 0, 0, 3, 10, 209
"/home/josh/repos/doughleap/frontend/src/app/recipes/state/recipe-step/recipe-step-reducers.ts", "TypeScript", 98, 0, 0, 0, 2, 100
"/home/josh/repos/doughleap/frontend/src/app/recipes/state/recipe-step/recipe-step-selectors.ts", "TypeScript", 18, 0, 0, 0, 8, 26
"/home/josh/repos/doughleap/frontend/src/app/recipes/state/recipe-step/recipe-step-state.ts", "TypeScript", 21, 0, 0, 0, 3, 24
"/home/josh/repos/doughleap/frontend/src/app/recipes/state/recipe-tool/recipe-tool-actions.ts", "TypeScript", 76, 0, 0, 0, 6, 82
"/home/josh/repos/doughleap/frontend/src/app/recipes/state/recipe-tool/recipe-tool-effects.ts", "TypeScript", 180, 0, 0, 0, 7, 187
"/home/josh/repos/doughleap/frontend/src/app/recipes/state/recipe-tool/recipe-tool-reducers.ts", "TypeScript", 133, 0, 0, 0, 5, 138
"/home/josh/repos/doughleap/frontend/src/app/recipes/state/recipe-tool/recipe-tool-selectors.ts", "TypeScript", 34, 0, 0, 1, 10, 45
"/home/josh/repos/doughleap/frontend/src/app/recipes/state/recipe-tool/recipe-tool-state.ts", "TypeScript", 20, 0, 0, 0, 3, 23
"/home/josh/repos/doughleap/frontend/src/app/recipes/state/recipe/recipe-actions.ts", "TypeScript", 182, 0, 0, 0, 14, 196
"/home/josh/repos/doughleap/frontend/src/app/recipes/state/recipe/recipe-effects.ts", "TypeScript", 393, 0, 0, 3, 19, 415
"/home/josh/repos/doughleap/frontend/src/app/recipes/state/recipe/recipe-reducers.ts", "TypeScript", 216, 0, 0, 0, 3, 219
"/home/josh/repos/doughleap/frontend/src/app/recipes/state/recipe/recipe-selectors.ts", "TypeScript", 38, 0, 0, 0, 13, 51
"/home/josh/repos/doughleap/frontend/src/app/recipes/state/recipe/recipe-state.ts", "TypeScript", 77, 0, 0, 1, 13, 91
"/home/josh/repos/doughleap/frontend/src/app/recipes/state/step/step-actions.ts", "TypeScript", 34, 0, 0, 0, 6, 40
"/home/josh/repos/doughleap/frontend/src/app/recipes/state/step/step-effects.ts", "TypeScript", 116, 0, 0, 0, 6, 122
"/home/josh/repos/doughleap/frontend/src/app/recipes/state/step/step-reducers.ts", "TypeScript", 93, 0, 0, 0, 2, 95
"/home/josh/repos/doughleap/frontend/src/app/recipes/state/step/step-selectors.ts", "TypeScript", 19, 0, 0, 0, 9, 28
"/home/josh/repos/doughleap/frontend/src/app/recipes/state/step/step-state.ts", "TypeScript", 19, 0, 0, 0, 2, 21
"/home/josh/repos/doughleap/frontend/src/app/routes.ts", "TypeScript", 180, 0, 0, 0, 2, 182
"/home/josh/repos/doughleap/frontend/src/app/settings/settings.component.html", "HTML", 0, 216, 0, 12, 10, 238
"/home/josh/repos/doughleap/frontend/src/app/settings/settings.component.ts", "TypeScript", 137, 0, 0, 1, 6, 144
"/home/josh/repos/doughleap/frontend/src/app/shared/state/app-state.ts", "TypeScript", 8, 0, 0, 0, 2, 10
"/home/josh/repos/doughleap/frontend/src/app/shared/state/shared-actions.ts", "TypeScript", 2, 0, 0, 0, 2, 4
"/home/josh/repos/doughleap/frontend/src/app/shared/state/shared-reducers.ts", "TypeScript", 10, 0, 0, 0, 3, 13
"/home/josh/repos/doughleap/frontend/src/app/shared/state/shared-selectors.ts", "TypeScript", 5, 0, 0, 0, 3, 8
"/home/josh/repos/doughleap/frontend/src/app/shared/state/shared-state.ts", "TypeScript", 82, 0, 0, 0, 7, 89
"/home/josh/repos/doughleap/frontend/src/app/shared/ui/add-request-confirmation/add-request-confirmation-modal.component.html", "HTML", 0, 12, 0, 0, 0, 12
"/home/josh/repos/doughleap/frontend/src/app/shared/ui/add-request-confirmation/add-request-confirmation-modal.component.ts", "TypeScript", 21, 0, 0, 0, 4, 25
"/home/josh/repos/doughleap/frontend/src/app/shared/ui/add-request-error/add-request-error-modal.component.html", "HTML", 0, 22, 0, 5, 0, 27
"/home/josh/repos/doughleap/frontend/src/app/shared/ui/add-request-error/add-request-error-modal.component.ts", "TypeScript", 21, 0, 0, 0, 4, 25
"/home/josh/repos/doughleap/frontend/src/app/shared/ui/app-notfound/app-notfound.component.html", "HTML", 0, 1, 0, 0, 1, 2
"/home/josh/repos/doughleap/frontend/src/app/shared/ui/app-notfound/app-notfound.component.ts", "TypeScript", 10, 0, 0, 0, 3, 13
"/home/josh/repos/doughleap/frontend/src/app/shared/ui/confirmation-modal/confirmation-modal.component.html", "HTML", 0, 12, 0, 0, 0, 12
"/home/josh/repos/doughleap/frontend/src/app/shared/ui/confirmation-modal/confirmation-modal.component.ts", "TypeScript", 16, 0, 0, 0, 2, 18
"/home/josh/repos/doughleap/frontend/src/app/shared/ui/delete-request-confirmation/delete-request-confirmation-modal.component.html", "HTML", 0, 22, 0, 0, 0, 22
"/home/josh/repos/doughleap/frontend/src/app/shared/ui/delete-request-confirmation/delete-request-confirmation-modal.component.ts", "TypeScript", 19, 0, 0, 0, 4, 23
"/home/josh/repos/doughleap/frontend/src/app/shared/ui/delete-request-error/delete-request-error-modal.component.html", "HTML", 0, 22, 0, 0, 0, 22
"/home/josh/repos/doughleap/frontend/src/app/shared/ui/delete-request-error/delete-request-error-modal.component.ts", "TypeScript", 19, 0, 0, 0, 3, 22
"/home/josh/repos/doughleap/frontend/src/app/shared/ui/dl-table-full-filters/dl-table-full-filters.component.html", "HTML", 0, 170, 0, 2, 2, 174
"/home/josh/repos/doughleap/frontend/src/app/shared/ui/dl-table-full-filters/dl-table-full-filters.component.ts", "TypeScript", 178, 0, 0, 2, 21, 201
"/home/josh/repos/doughleap/frontend/src/app/shared/ui/dl-table-full/dl-table-full.component.html", "HTML", 0, 179, 0, 1, 1, 181
"/home/josh/repos/doughleap/frontend/src/app/shared/ui/dl-table-full/dl-table-full.component.ts", "TypeScript", 314, 0, 0, 6, 25, 345
"/home/josh/repos/doughleap/frontend/src/app/shared/ui/error-modal/error-modal.component.html", "HTML", 0, 24, 0, 0, 1, 25
"/home/josh/repos/doughleap/frontend/src/app/shared/ui/error-modal/error-modal.component.ts", "TypeScript", 20, 0, 0, 0, 3, 23
"/home/josh/repos/doughleap/frontend/src/app/shared/ui/filterModals/currency-filter-modal/currency-filter-modal.component.html", "HTML", 0, 1, 0, 0, 1, 2
"/home/josh/repos/doughleap/frontend/src/app/shared/ui/filterModals/currency-filter-modal/currency-filter-modal.component.ts", "TypeScript", 10, 0, 0, 0, 3, 13
"/home/josh/repos/doughleap/frontend/src/app/shared/ui/filterModals/date-filter-modal/date-filter-modal.component.html", "HTML", 0, 104, 0, 2, 2, 108
"/home/josh/repos/doughleap/frontend/src/app/shared/ui/filterModals/date-filter-modal/date-filter-modal.component.ts", "TypeScript", 131, 0, 0, 3, 11, 145
"/home/josh/repos/doughleap/frontend/src/app/shared/ui/filterModals/numeric-filter-modal/numeric-filter-modal.component.html", "HTML", 0, 83, 0, 2, 2, 87
"/home/josh/repos/doughleap/frontend/src/app/shared/ui/filterModals/numeric-filter-modal/numeric-filter-modal.component.ts", "TypeScript", 112, 0, 0, 0, 10, 122
"/home/josh/repos/doughleap/frontend/src/app/shared/ui/filterModals/string-filter-modal/string-filter-modal.component.html", "HTML", 0, 63, 0, 2, 2, 67
"/home/josh/repos/doughleap/frontend/src/app/shared/ui/filterModals/string-filter-modal/string-filter-modal.component.ts", "TypeScript", 80, 0, 0, 2, 8, 90
"/home/josh/repos/doughleap/frontend/src/app/shared/ui/update-request-confirmation/update-request-confirmation-modal.component.html", "HTML", 0, 12, 0, 0, 0, 12
"/home/josh/repos/doughleap/frontend/src/app/shared/ui/update-request-confirmation/update-request-confirmation-modal.component.ts", "TypeScript", 20, 0, 0, 0, 8, 28
"/home/josh/repos/doughleap/frontend/src/app/shared/ui/update-request-error/update-request-error-modal.component.html", "HTML", 0, 22, 0, 5, 0, 27
"/home/josh/repos/doughleap/frontend/src/app/shared/ui/update-request-error/update-request-error-modal.component.ts", "TypeScript", 20, 0, 0, 0, 5, 25
"/home/josh/repos/doughleap/frontend/src/app/shared/utils/ID.ts", "TypeScript", 58, 0, 0, 1, 2, 61
"/home/josh/repos/doughleap/frontend/src/app/shared/utils/authInterceptor.ts", "TypeScript", 33, 0, 0, 0, 4, 37
"/home/josh/repos/doughleap/frontend/src/app/shared/utils/authenticationService.ts", "TypeScript", 353, 0, 0, 39, 36, 428
"/home/josh/repos/doughleap/frontend/src/app/shared/utils/filterService.ts", "TypeScript", 121, 0, 0, 7, 7, 135
"/home/josh/repos/doughleap/frontend/src/app/shared/utils/formValidator.ts", "TypeScript", 69, 0, 0, 0, 14, 83
"/home/josh/repos/doughleap/frontend/src/app/shared/utils/fractionService.ts", "TypeScript", 45, 0, 0, 4, 5, 54
"/home/josh/repos/doughleap/frontend/src/app/shared/utils/logService.ts", "TypeScript", 48, 0, 0, 0, 7, 55
"/home/josh/repos/doughleap/frontend/src/app/shared/utils/photoService.ts", "TypeScript", 51, 0, 0, 0, 7, 58
"/home/josh/repos/doughleap/frontend/src/app/shared/utils/pushTokenService.ts", "TypeScript", 174, 0, 0, 0, 10, 184
"/home/josh/repos/doughleap/frontend/src/app/shared/utils/sortingService.ts", "TypeScript", 40, 0, 0, 4, 7, 51
"/home/josh/repos/doughleap/frontend/src/app/shared/utils/supabase.service.ts", "TypeScript", 26, 0, 0, 1, 3, 30
"/home/josh/repos/doughleap/frontend/src/app/shared/utils/types.ts", "TypeScript", 124, 0, 0, 1, 4, 129
"/home/josh/repos/doughleap/frontend/src/app/shared/utils/unitService.ts", "TypeScript", 69, 0, 0, 0, 6, 75
"/home/josh/repos/doughleap/frontend/src/app/social/data/social.service.ts", "TypeScript", 101, 0, 0, 11, 16, 128
"/home/josh/repos/doughleap/frontend/src/app/social/feature/followers/followers.component.html", "HTML", 0, 70, 0, 4, 4, 78
"/home/josh/repos/doughleap/frontend/src/app/social/feature/followers/followers.component.ts", "TypeScript", 57, 0, 0, 3, 9, 69
"/home/josh/repos/doughleap/frontend/src/app/social/feature/friends/friends.component.html", "HTML", 0, 70, 0, 6, 4, 80
"/home/josh/repos/doughleap/frontend/src/app/social/feature/friends/friends.component.ts", "TypeScript", 105, 0, 0, 1, 12, 118
"/home/josh/repos/doughleap/frontend/src/app/social/feature/friends/ui/add-friend-modal/add-friend-modal.component.html", "HTML", 0, 93, 0, 3, 2, 98
"/home/josh/repos/doughleap/frontend/src/app/social/feature/friends/ui/add-friend-modal/add-friend-modal.component.ts", "TypeScript", 424, 0, 0, 4, 16, 444
"/home/josh/repos/doughleap/frontend/src/app/social/feature/friends/ui/friend-card/friend-card.component.html", "HTML", 0, 38, 0, 4, 3, 45
"/home/josh/repos/doughleap/frontend/src/app/social/feature/friends/ui/friend-card/friend-card.component.ts", "TypeScript", 17, 0, 0, 0, 3, 20
"/home/josh/repos/doughleap/frontend/src/app/social/feature/friends/ui/friend-modal/friend-modal.component.html", "HTML", 0, 225, 0, 15, 10, 250
"/home/josh/repos/doughleap/frontend/src/app/social/feature/friends/ui/friend-modal/friend-modal.component.ts", "TypeScript", 448, 0, 0, 10, 19, 477
"/home/josh/repos/doughleap/frontend/src/app/social/feature/friends/ui/friend-requests-modal/friend-requests-modal.component.html", "HTML", 0, 16, 0, 0, 1, 17
"/home/josh/repos/doughleap/frontend/src/app/social/feature/friends/ui/friend-requests-modal/friend-requests-modal.component.ts", "TypeScript", 37, 0, 0, 1, 6, 44
"/home/josh/repos/doughleap/frontend/src/app/social/feature/friends/ui/profile-card/profile-card.component.html", "HTML", 0, 128, 0, 11, 4, 143
"/home/josh/repos/doughleap/frontend/src/app/social/feature/friends/ui/profile-card/profile-card.component.ts", "TypeScript", 72, 0, 0, 3, 7, 82
"/home/josh/repos/doughleap/frontend/src/app/social/feature/friends/ui/request-card/request-card.component.html", "HTML", 0, 47, 0, 6, 2, 55
"/home/josh/repos/doughleap/frontend/src/app/social/feature/friends/ui/request-card/request-card.component.ts", "TypeScript", 43, 0, 0, 1, 7, 51
"/home/josh/repos/doughleap/frontend/src/app/social/feature/timeline/state/timeline-state.ts", "TypeScript", 5, 0, 0, 0, 1, 6
"/home/josh/repos/doughleap/frontend/src/app/social/feature/timeline/timeline.component.html", "HTML", 0, 82, 0, 0, 1, 83
"/home/josh/repos/doughleap/frontend/src/app/social/feature/timeline/timeline.component.ts", "TypeScript", 75, 0, 0, 3, 11, 89
"/home/josh/repos/doughleap/frontend/src/app/social/feature/timeline/ui/event/event.component.html", "HTML", 0, 1, 0, 0, 1, 2
"/home/josh/repos/doughleap/frontend/src/app/social/feature/timeline/ui/event/event.component.ts", "TypeScript", 10, 0, 0, 0, 3, 13
"/home/josh/repos/doughleap/frontend/src/app/social/social-page.component.html", "HTML", 0, 27, 0, 13, 2, 42
"/home/josh/repos/doughleap/frontend/src/app/social/social-page.component.ts", "TypeScript", 62, 0, 0, 0, 8, 70
"/home/josh/repos/doughleap/frontend/src/app/social/state/followship-actions.ts", "TypeScript", 73, 0, 0, 0, 6, 79
"/home/josh/repos/doughleap/frontend/src/app/social/state/followship-effects.ts", "TypeScript", 139, 0, 0, 0, 8, 147
"/home/josh/repos/doughleap/frontend/src/app/social/state/followship-reducers.ts", "TypeScript", 98, 0, 0, 0, 2, 100
"/home/josh/repos/doughleap/frontend/src/app/social/state/followship-selectors.ts", "TypeScript", 21, 0, 0, 0, 11, 32
"/home/josh/repos/doughleap/frontend/src/app/social/state/followship-state.ts", "TypeScript", 20, 0, 0, 0, 2, 22
"/home/josh/repos/doughleap/frontend/src/app/social/state/friendship-actions.ts", "TypeScript", 76, 0, 0, 0, 7, 83
"/home/josh/repos/doughleap/frontend/src/app/social/state/friendship-effects.ts", "TypeScript", 149, 0, 0, 0, 9, 158
"/home/josh/repos/doughleap/frontend/src/app/social/state/friendship-reducers.ts", "TypeScript", 102, 0, 0, 0, 2, 104
"/home/josh/repos/doughleap/frontend/src/app/social/state/friendship-selectors.ts", "TypeScript", 20, 0, 0, 0, 9, 29
"/home/josh/repos/doughleap/frontend/src/app/social/state/friendship-state.ts", "TypeScript", 21, 0, 0, 0, 2, 23
"Total", "-", 23269, 8803, 59, 885, 2223, 35239